district,population,Males,Females,pop_desnity,geometry,_merge
GARHWA,1322387,683984,638403,327,"POLYGON Z ((83.50411224365246 24.526332855224723 0, 83.51544189453125 24.52681922912609 0, 83.53781890869146 24.529590606689396 0, 83.58279418945312 24.52240943908697 0, 83.62512969970703 24.519384384155273 0, 83.6425170898438 24.52278709411621 0, 83.66490173339855 24.519510269165096 0, 83.69202423095697 24.516738891601562 0, 83.71886444091808 24.50993537902832 0, 83.73435974121088 24.51258087158203 0, 83.7498550415039 24.517873764038086 0, 83.76974487304693 24.526830673217773 0, 83.80508422851574 24.53741836547846 0, 83.83187103271484 24.540172576904354 0, 83.85387420654303 24.535850524902344 0, 83.8634719848634 24.537117004394474 0, 83.86406707763666 24.53684806823742 0, 83.8570556640625 24.525407791137695 0, 83.85398864746094 24.52032661437994 0, 83.84973907470714 24.509471893310604 0, 83.84883880615234 24.50263214111328 0, 83.84571075439464 24.4771347045899 0, 83.84592437744152 24.471292495727596 0, 83.84729766845703 24.458415985107536 0, 83.84274291992188 24.423027038574332 0, 83.84091949462896 24.409481048583984 0, 83.82967376708996 24.396104812622127 0, 83.81272125244152 24.38789367675787 0, 83.80545806884777 24.380336761474666 0, 83.80277252197271 24.36769104003912 0, 83.80737304687511 24.354118347168026 0, 83.81252288818371 24.34387016296381 0, 83.81800079345709 24.33194541931158 0, 83.81762695312506 24.326713562011832 0, 83.81712341308605 24.319700241088867 0, 83.81118774414074 24.302938461303768 0, 83.81118774414074 24.296586990356502 0, 83.82151031494152 24.27911758422863 0, 83.84374237060553 24.24814987182623 0, 83.85645294189453 24.230283737182674 0, 83.86478424072277 24.21162414550787 0, 83.87947845458996 24.20249366760254 0, 83.90409088134777 24.183435440063533 0, 83.91918182373041 24.16874504089367 0, 83.94458770751953 24.158025741577205 0, 83.97370910644543 24.15121841430664 0, 83.97793579101557 24.14587211608881 0, 83.98099517822266 24.13114738464367 0, 83.9812622070313 24.120958328247184 0, 83.9808578491211 24.108661651611328 0, 83.97595977783209 24.101156234741268 0, 83.96145629882818 24.109361648559513 0, 83.95558929443371 24.107761383056697 0, 83.94095611572266 24.09846687316906 0, 83.92993927001959 24.09607887268072 0, 83.91426086425781 24.095188140869197 0, 83.88931274414068 24.086427688598746 0, 83.88067626953125 24.07955360412609 0, 83.85043334960943 24.040891647338924 0, 83.84095764160168 24.03265380859375 0, 83.83353424072277 24.022430419921932 0, 83.8332977294923 24.011014938354606 0, 83.83856964111328 23.99936866760254 0, 83.83901977539074 23.994291305541992 0, 83.8370971679688 23.987062454223746 0, 83.83503723144543 23.983963012695426 0, 83.82835388183605 23.975950241088867 0, 83.82528686523449 23.970592498779297 0, 83.82530975341808 23.968013763427848 0, 83.8350296020509 23.961229324340877 0, 83.84808349609375 23.962007522583065 0, 83.85458374023438 23.969114303588867 0, 83.86013793945318 23.974880218505973 0, 83.87643432617199 23.99141502380371 0, 83.88319396972656 23.996217727661246 0, 83.88700103759766 23.996213912963867 0, 83.89158630371094 23.99195289611822 0, 83.89579772949224 23.985305786132926 0, 83.89836883544933 23.974094390869197 0, 83.90122985839855 23.965915679931754 0, 83.90717315673822 23.956920623779354 0, 83.9188232421875 23.949235916137752 0, 83.92989349365234 23.942613601684684 0, 83.93476867675793 23.938251495361385 0, 83.93515777587902 23.934465408325195 0, 83.9179306030274 23.915008544921875 0, 83.91880798339838 23.904300689697322 0, 83.9295425415039 23.894630432128963 0, 83.93440246582043 23.883268356323242 0, 83.9416885375976 23.872577667236328 0, 83.95144653320312 23.867351531982365 0, 83.96313476562506 23.86631393432623 0, 83.97488403320307 23.860757827758846 0, 83.97940826416027 23.85133743286127 0, 83.98168182373053 23.837459564208984 0, 83.98737335205084 23.82717895507824 0, 83.9976654052735 23.816778182983455 0, 84.00897216796886 23.81316566467285 0, 84.02022552490246 23.814527511596793 0, 84.02272033691418 23.81427764892578 0, 84.02551269531256 23.810520172119084 0, 84.02511596679693 23.807399749755916 0, 84.02588653564459 23.80323410034191 0, 84.02265167236334 23.79897117614746 0, 84.01190185546875 23.784807205200252 0, 84.00585174560553 23.773727416992244 0, 83.99665069580078 23.751399993896428 0, 83.99004364013678 23.741531372070426 0, 83.98703002929699 23.734516143798885 0, 83.98747253417963 23.72953033447277 0, 83.99681091308588 23.720811843872184 0, 84.00990295410162 23.720376968383846 0, 84.03816986083996 23.705907821655273 0, 84.05212402343744 23.69135093688959 0, 84.0551223754884 23.684823989868164 0, 84.05480194091791 23.681146621704045 0, 84.0498428344726 23.669672012329215 0, 84.0259475708009 23.64727210998535 0, 84.01167297363293 23.63834381103527 0, 84.00749969482416 23.634712219238395 0, 84.00684356689459 23.63414001464855 0, 84.0061492919923 23.633514404296932 0, 83.99799346923828 23.633930206298828 0, 83.98078918457026 23.631687164306697 0, 83.96802520751953 23.62705421447754 0, 83.95394897460938 23.625169754028377 0, 83.94451904296886 23.623510360717773 0, 83.94322967529297 23.623281478881836 0, 83.9368515014649 23.61225700378418 0, 83.9349212646485 23.594562530517692 0, 83.94032287597668 23.565473556518498 0, 83.94060516357422 23.5639705657959 0, 83.92781066894531 23.565967559814567 0, 83.92002105712896 23.569646835327262 0, 83.91061401367188 23.57040786743164 0, 83.90383148193365 23.572052001953125 0, 83.89543151855474 23.57679557800293 0, 83.88827514648449 23.57364273071289 0, 83.86496734619152 23.57917785644537 0, 83.85153198242188 23.581754684448242 0, 83.843002319336 23.582180023193473 0, 83.82660675048834 23.5856552124024 0, 83.8170776367188 23.589336395263672 0, 83.8162689208985 23.58964729309082 0, 83.81262969970703 23.58441734313965 0, 83.81172180175787 23.583106994628906 0, 83.80586242675793 23.583967208862248 0, 83.80311584472662 23.59086990356451 0, 83.7915496826173 23.59893417358404 0, 83.78030395507824 23.60024452209484 0, 83.77319335937506 23.609806060791072 0, 83.77115631103527 23.618253707885856 0, 83.77037048339855 23.622186660766715 0, 83.7532196044923 23.627328872680778 0, 83.74846649169933 23.641122817993164 0, 83.75006866455078 23.646308898925838 0, 83.75177764892578 23.647071838378963 0, 83.7575302124024 23.64963912963873 0, 83.75744628906244 23.64995765686041 0, 83.75637817382818 23.653980255126953 0, 83.74948120117188 23.659769058227653 0, 83.73436737060541 23.66800880432129 0, 83.72679138183594 23.67432785034174 0, 83.72019195556652 23.683115005493164 0, 83.7205429077149 23.690799713134766 0, 83.72237396240234 23.691751480102596 0, 83.72804260253918 23.694704055786076 0, 83.72825622558588 23.695035934448242 0, 83.72977447509777 23.69734382629406 0, 83.7376098632812 23.705230712890682 0, 83.74018096923834 23.714097976684684 0, 83.73794555664074 23.72452163696289 0, 83.7348251342774 23.732345581054744 0, 83.73548889160168 23.744180679321346 0, 83.73488616943371 23.755212783813477 0, 83.73259735107433 23.760375976562557 0, 83.71786499023443 23.77278137207037 0, 83.718017578125 23.781269073486385 0, 83.71630859375 23.789955139160213 0, 83.71326446533209 23.795356750488224 0, 83.7054214477539 23.802028656005916 0, 83.70112609863293 23.80797195434576 0, 83.70411682128912 23.816833496093807 0, 83.70090484619146 23.82103157043457 0, 83.6940307617188 23.824285507202262 0, 83.68771362304693 23.826095581054688 0, 83.68754577636724 23.826143264770508 0, 83.68446350097662 23.823890686035213 0, 83.68326568603516 23.823013305664006 0, 83.677734375 23.82042121887207 0, 83.67205047607422 23.82625770568859 0, 83.66387176513678 23.828142166137752 0, 83.6608276367188 23.832326889038086 0, 83.6631469726563 23.837276458740234 0, 83.6618041992188 23.843940734863395 0, 83.65510559082037 23.84834861755371 0, 83.64346313476568 23.847314834594727 0, 83.63555145263683 23.847629547119197 0, 83.61706542968744 23.853609085083008 0, 83.6061477661134 23.85372352600109 0, 83.59603118896496 23.85671997070324 0, 83.58676147460938 23.862131118774528 0, 83.57736206054699 23.86326980590826 0, 83.56681823730474 23.863147735595817 0, 83.56321716308605 23.869712829589957 0, 83.56510162353521 23.870805740356445 0, 83.56930541992193 23.87324142456066 0, 83.57862091064459 23.87725257873535 0, 83.5788192749024 23.877725601196346 0, 83.58176422119152 23.884559631347713 0, 83.5757675170899 23.89052391052246 0, 83.56611633300793 23.892812728881836 0, 83.5549926757813 23.89298248291027 0, 83.54847717285162 23.89837265014654 0, 83.542953491211 23.91472816467291 0, 83.54457855224604 23.933580398559627 0, 83.53939056396496 23.94179916381836 0, 83.5282592773438 23.952205657959098 0, 83.51810455322266 23.96701240539562 0, 83.51340484619146 23.979444503784237 0, 83.51221466064453 23.99130821228033 0, 83.51320648193365 24.001346588134822 0, 83.52222442626964 24.010576248168945 0, 83.52050781250011 24.015701293945312 0, 83.5153198242188 24.02533149719244 0, 83.51240539550781 24.0281600952149 0, 83.50692749023443 24.030599594116268 0, 83.48464965820324 24.03843116760254 0, 83.47412872314459 24.040540695190543 0, 83.46385192871105 24.04178047180187 0, 83.45879364013672 24.041275024414062 0, 83.45331573486334 24.04233169555664 0, 83.43897247314453 24.05451011657709 0, 83.43704986572266 24.057743072509766 0, 83.43495178222656 24.061832427978572 0, 83.43634796142584 24.068855285644645 0, 83.43587493896484 24.07380485534668 0, 83.434341430664 24.079557418823242 0, 83.43112182617188 24.083536148071346 0, 83.4271240234375 24.083555221557617 0, 83.4204330444336 24.0809841156007 0, 83.41470336914062 24.08024406433117 0, 83.4088363647461 24.080547332763786 0, 83.40647125244152 24.0815372467041 0, 83.39817047119146 24.09467697143566 0, 83.3890228271485 24.099596023559684 0, 83.36775970458996 24.101655960083065 0, 83.36302185058594 24.101387023925838 0, 83.35152435302746 24.096744537353572 0, 83.33338928222668 24.099325180053825 0, 83.32934570312506 24.10099983215332 0, 83.33127593994146 24.102138519287223 0, 83.34483337402355 24.11011886596691 0, 83.3485946655274 24.11390876770031 0, 83.34935760498053 24.118448257446346 0, 83.35481262207031 24.126091003417912 0, 83.35572814941418 24.136737823486328 0, 83.3582992553711 24.13995552062994 0, 83.36187744140625 24.14736175537115 0, 83.36315917968761 24.156459808349723 0, 83.37139129638666 24.171569824218807 0, 83.3751678466798 24.18019104003912 0, 83.37631988525402 24.18634986877447 0, 83.38417816162104 24.200368881225643 0, 83.38406372070318 24.20485496520996 0, 83.3820266723634 24.209697723388786 0, 83.38185882568371 24.21343612670904 0, 83.38423156738281 24.21642875671398 0, 83.38512420654291 24.219760894775447 0, 83.38272857666021 24.230474472045955 0, 83.38318634033214 24.23519325256359 0, 83.38670349121094 24.239553451538086 0, 83.39695739746088 24.244186401367188 0, 83.3992691040039 24.246658325195312 0, 83.39923095703136 24.25218582153326 0, 83.40772247314459 24.265512466430778 0, 83.4087600708009 24.275632858276367 0, 83.40636444091797 24.28473472595209 0, 83.40202331542974 24.292867660522518 0, 83.39635467529308 24.29598617553711 0, 83.39242553710938 24.29703330993658 0, 83.38769531250006 24.299343109130973 0, 83.3864974975586 24.299924850463924 0, 83.38614654541016 24.30424499511713 0, 83.38148498535168 24.312887191772518 0, 83.38180541992193 24.31398200988781 0, 83.38449096679693 24.314950942993278 0, 83.39118957519543 24.319770812988338 0, 83.39727783203136 24.326198577880916 0, 83.40919494628906 24.336816787719783 0, 83.41277313232433 24.338413238525447 0, 83.4170761108399 24.338979721069393 0, 83.42938995361328 24.33814048767084 0, 83.43245697021484 24.33939933776861 0, 83.43590545654297 24.344394683837834 0, 83.44017791748053 24.346916198730582 0, 83.44692230224604 24.360305786132756 0, 83.45155334472656 24.362701416015682 0, 83.45724487304688 24.364185333252067 0, 83.45732116699224 24.366432189941406 0, 83.45352172851568 24.367876052856502 0, 83.44909667968756 24.372209548950195 0, 83.44867706298828 24.377046585083065 0, 83.44563293457031 24.379524230957145 0, 83.44585418701178 24.386373519897575 0, 83.44473266601568 24.388389587402344 0, 83.44061279296886 24.39001274108881 0, 83.43881988525396 24.393417358398494 0, 83.43638610839855 24.395383834838867 0, 83.43579101562506 24.40315246582037 0, 83.43212127685553 24.405405044555664 0, 83.42243957519537 24.408828735351562 0, 83.41786956787115 24.409587860107536 0, 83.4060516357423 24.40801239013672 0, 83.40487670898443 24.411411285400447 0, 83.4066009521485 24.436441421508903 0, 83.39840698242193 24.435714721679688 0, 83.39572143554693 24.436870574951286 0, 83.38735198974615 24.454910278320256 0, 83.39019012451178 24.460659027099666 0, 83.39307403564459 24.463819503784293 0, 83.39414978027344 24.467380523681754 0, 83.39410400390625 24.4725017547608 0, 83.39852142333984 24.479515075683537 0, 83.39941406250011 24.48399925231945 0, 83.39955902099615 24.48814201354986 0, 83.39756774902344 24.49206352233881 0, 83.39808654785168 24.496322631835938 0, 83.39897918701178 24.500400543212834 0, 83.4014282226563 24.502985000610465 0, 83.40594482421875 24.50527381896984 0, 83.43232727050787 24.51199913024908 0, 83.4415893554687 24.512834548950252 0, 83.45906066894537 24.516351699829215 0, 83.46782684326178 24.51712608337408 0, 83.48731994628918 24.523172378540096 0, 83.49264526367199 24.52360916137701 0, 83.50411224365246 24.526332855224723 0))",both
CHATRA,1042304,534209,508095,275,"POLYGON Z ((84.46731567382824 24.3178653717041 0, 84.47444915771484 24.31866264343273 0, 84.48008728027355 24.317668914795036 0, 84.48307037353521 24.316394805908203 0, 84.48666381835938 24.31869506835949 0, 84.4966049194336 24.330175399780273 0, 84.50275421142584 24.334531784057617 0, 84.50615692138678 24.332855224609318 0, 84.50695037841803 24.328144073486442 0, 84.5043411254884 24.32441139221197 0, 84.5011138916015 24.32153892517084 0, 84.49198913574219 24.317764282226676 0, 84.48796081542963 24.31530380249029 0, 84.48584747314464 24.312715530395508 0, 84.48441314697271 24.309616088867188 0, 84.48390960693371 24.30323219299322 0, 84.48067474365246 24.30289840698248 0, 84.4737396240235 24.305604934692496 0, 84.470458984375 24.308715820312557 0, 84.46731567382824 24.3178653717041 0))",both
CHATRA,1042304,534209,508095,275,"POLYGON Z ((84.80058288574219 24.52978324890148 0, 84.806884765625 24.52142524719244 0, 84.82472991943365 24.52513504028326 0, 84.83784484863287 24.51181602478033 0, 84.83313751220714 24.486364364624023 0, 84.83238983154308 24.470495223999137 0, 84.83865356445318 24.469982147216854 0, 84.8379364013673 24.46156120300293 0, 84.83582305908214 24.45960998535162 0, 84.839584350586 24.452938079833984 0, 84.84716796875 24.45588493347168 0, 84.85266876220703 24.466344833374023 0, 84.86252593994152 24.461189270019645 0, 84.8622055053711 24.4580078125 0, 84.8649291992188 24.4570636749267 0, 84.86810302734375 24.45807266235346 0, 84.8726272583009 24.46733474731451 0, 84.87789916992193 24.46625137329113 0, 84.88142395019543 24.463220596313477 0, 84.8853378295899 24.46323966979992 0, 84.88320922851562 24.444253921508903 0, 84.8852005004884 24.43251037597662 0, 84.88304901123053 24.423122406005973 0, 84.88748931884777 24.4175968170166 0, 84.8970413208009 24.399063110351562 0, 84.90329742431646 24.394348144531307 0, 84.90560913085949 24.382637023925724 0, 84.89952850341808 24.375597000122184 0, 84.90312194824224 24.372692108154354 0, 84.9084091186524 24.372875213623047 0, 84.91807556152344 24.376220703125057 0, 84.93043518066418 24.378620147705135 0, 84.9400405883789 24.37704467773449 0, 84.95301818847656 24.37237548828125 0, 84.9736328125 24.376556396484375 0, 84.99546813964855 24.41280555725092 0, 85.00000000000006 24.41366958618164 0, 85.01575469970703 24.416671752929744 0, 85.01966094970709 24.419698715210018 0, 85.0257186889649 24.422609329223633 0, 85.03713989257812 24.425939559936523 0, 85.040771484375 24.423704147338924 0, 85.04458618164062 24.424724578857422 0, 85.04728698730474 24.418886184692496 0, 85.05831146240234 24.415748596191463 0, 85.0625 24.417102813720703 0, 85.06542205810553 24.425222396850643 0, 85.06962585449224 24.431198120117244 0, 85.07408142089838 24.436267852783317 0, 85.0811996459961 24.440471649170036 0, 85.08069610595709 24.42237472534191 0, 85.07875823974615 24.413637161254883 0, 85.07955932617199 24.409099578857422 0, 85.07801818847662 24.407186508178654 0, 85.07540130615246 24.40582084655773 0, 85.07421875000011 24.40184974670416 0, 85.07600402832031 24.40033912658697 0, 85.07047271728516 24.38742637634283 0, 85.0856323242188 24.381444931030217 0, 85.08179473876959 24.365556716918945 0, 85.08261108398449 24.35576248168951 0, 85.08808135986334 24.346460342407227 0, 85.08930969238293 24.344577789306584 0, 85.08978271484375 24.329399108886832 0, 85.08992767333984 24.32456398010254 0, 85.09189605712896 24.32090568542486 0, 85.09911346435547 24.31781005859375 0, 85.11126708984386 24.320077896118278 0, 85.14385986328136 24.34064292907715 0, 85.14981842041016 24.343667984008846 0, 85.15587615966808 24.344385147094727 0, 85.16255187988293 24.34020042419445 0, 85.16870880126953 24.333036422729492 0, 85.1741561889649 24.326173782348746 0, 85.18022918701178 24.319795608520508 0, 85.19314575195312 24.322883605957145 0, 85.21638488769531 24.32846260070812 0, 85.23412322998047 24.329671859741268 0, 85.24358367919928 24.328193664550838 0, 85.26439666748058 24.326028823852482 0, 85.2794876098634 24.324354171753043 0, 85.30496215820318 24.318580627441406 0, 85.32391357421886 24.31000137329113 0, 85.33119964599604 24.303852081298885 0, 85.33370208740234 24.291534423828182 0, 85.33301544189459 24.28692626953125 0, 85.322494506836 24.282960891723633 0, 85.31628417968761 24.27856826782238 0, 85.31217956542969 24.262224197387752 0, 85.31099700927734 24.245212554931584 0, 85.3093948364259 24.2405681610108 0, 85.30175781250006 24.230697631835994 0, 85.29262542724621 24.223640441894588 0, 85.28831481933594 24.216602325439396 0, 85.28828430175776 24.210889816284293 0, 85.29193878173828 24.199615478515682 0, 85.29194641113281 24.187452316284123 0, 85.28895568847662 24.185619354248104 0, 85.2858657836914 24.186187744140625 0, 85.2715682983399 24.197643280029354 0, 85.26642608642584 24.199571609497013 0, 85.23541259765636 24.209217071533203 0, 85.22207641601574 24.213432312011832 0, 85.21277618408203 24.215412139892692 0, 85.1943817138673 24.216674804687614 0, 85.18379974365234 24.21841621398937 0, 85.17060089111322 24.219964981079215 0, 85.16235351562511 24.219690322876033 0, 85.14918518066418 24.214420318603572 0, 85.14446258544916 24.209419250488395 0, 85.14470672607422 24.201637268066406 0, 85.14544677734375 24.193147659301758 0, 85.14506530761719 24.176597595214957 0, 85.14149475097662 24.172754287719783 0, 85.14225769042974 24.16674041748047 0, 85.14635467529308 24.15797615051281 0, 85.1512298583985 24.150777816772518 0, 85.15326690673828 24.14803504943859 0, 85.1575317382813 24.13416290283203 0, 85.15812683105474 24.134050369262752 0, 85.16201019287104 24.115285873413143 0, 85.16437530517584 24.106935501098633 0, 85.16603088378906 24.103101730346793 0, 85.17263031005865 24.09660148620611 0, 85.17560577392578 24.094209671020565 0, 85.17937469482416 24.087909698486328 0, 85.18504333496105 24.081727981567383 0, 85.19953918457043 24.06795692443842 0, 85.20789337158209 24.060867309570256 0, 85.21121215820324 24.059055328369084 0, 85.23078918457037 24.04645156860346 0, 85.2311401367188 24.041511535644588 0, 85.23002624511724 24.027587890625057 0, 85.22561645507818 24.015390396118164 0, 85.21994781494152 24.004066467285156 0, 85.205795288086 23.983816146850586 0, 85.1731796264649 23.949991226196346 0, 85.15892791748058 23.937763214111328 0, 85.14855957031256 23.93329620361328 0, 85.14199829101562 23.93121337890625 0, 85.12560272216797 23.92902183532709 0, 85.11378479003906 23.92932510375988 0, 85.10629272460949 23.932466506958065 0, 85.10295104980469 23.93420028686529 0, 85.09880065917974 23.938301086425838 0, 85.0916748046875 23.94830513000494 0, 85.08773803710943 23.94769859313959 0, 85.08312225341803 23.944995880126896 0, 85.07987213134766 23.946393966674805 0, 85.07837677001959 23.951879501342887 0, 85.07913208007818 23.95821189880371 0, 85.0782852172851 23.96478271484375 0, 85.07577514648449 23.96726036071783 0, 85.07132720947271 23.968975067138786 0, 85.06719970703136 23.968557357788086 0, 85.06406402587896 23.967741012573185 0, 85.06033325195324 23.969799041748047 0, 85.05677032470703 23.973508834838867 0, 85.04659271240246 23.987665176391545 0, 85.04360961914062 23.988409042358455 0, 85.04175567626959 23.98718070983881 0, 85.03968048095709 23.985313415527457 0, 85.036376953125 23.980354309082145 0, 85.03550720214855 23.973472595214957 0, 85.03813934326178 23.96289443969738 0, 85.04267883300781 23.943937301635742 0, 85.05269622802746 23.9334716796875 0, 85.05475616455084 23.929718017578182 0, 85.05561065673828 23.92600250244135 0, 85.05344390869152 23.919164657592773 0, 85.0449829101563 23.907833099365234 0, 85.04219055175793 23.905622482299805 0, 85.03301239013678 23.90150070190424 0, 85.02689361572271 23.896358489990178 0, 85.0264663696289 23.892963409423828 0, 85.02930450439453 23.88098335266119 0, 85.03453826904303 23.868648529052848 0, 85.03689575195307 23.861818313598633 0, 85.03839111328136 23.85713005065918 0, 85.04071807861328 23.84725379943859 0, 85.04764556884771 23.834861755371094 0, 85.05089569091803 23.829523086547965 0, 85.05376434326178 23.824802398681754 0, 85.0541610717774 23.819444656372013 0, 85.05341339111334 23.815690994262695 0, 85.04703521728516 23.808898925781193 0, 85.04312896728527 23.806171417236328 0, 85.0436401367188 23.801454544067496 0, 85.04778289794922 23.797264099121037 0, 85.05046844482422 23.791555404663086 0, 85.05070495605474 23.787309646606502 0, 85.04823303222662 23.782968521118278 0, 85.04845428466803 23.781024932861328 0, 85.05067443847656 23.77441787719738 0, 85.05621337890625 23.75911521911621 0, 85.05742645263678 23.74912452697754 0, 85.05786895751947 23.737499237060547 0, 85.05342102050787 23.726129531860465 0, 85.05297088623047 23.714534759521598 0, 85.05358123779303 23.712118148803825 0, 85.05610656738293 23.709798812866268 0, 85.05563354492188 23.70969390869152 0, 85.05335998535156 23.710706710815487 0, 85.05162048339844 23.714031219482422 0, 85.04761505126953 23.711790084838867 0, 85.0464248657226 23.708312988281307 0, 85.04445648193365 23.706317901611385 0, 85.03926086425787 23.703815460205135 0, 85.03907775878912 23.699995040893555 0, 85.03636169433594 23.693536758422965 0, 85.03399658203136 23.690149307250977 0, 85.01560211181646 23.687500000000057 0, 85.01332855224615 23.691856384277344 0, 85.00962066650385 23.693374633789062 0, 85.00930786132818 23.687273025512695 0, 85.00503540039057 23.678831100463867 0, 85.00000000000006 23.680368423462028 0, 84.99539947509771 23.681772232055664 0, 84.99014282226574 23.689888000488224 0, 84.98744201660168 23.700496673583984 0, 84.98553466796886 23.70399665832531 0, 84.97650909423834 23.706502914428768 0, 84.97382354736328 23.70835876464855 0, 84.97035217285156 23.715234756469783 0, 84.96650695800776 23.71555900573742 0, 84.96174621582026 23.71431541442871 0, 84.95891571044922 23.712490081787053 0, 84.95932006835938 23.721887588501033 0, 84.93900299072277 23.727600097656364 0, 84.93637847900385 23.72947502136242 0, 84.93354797363281 23.737634658813477 0, 84.92646789550781 23.75164985656744 0, 84.9250946044923 23.76383209228527 0, 84.92572784423828 23.76842689514166 0, 84.91911315917974 23.770874023437557 0, 84.90777587890625 23.772241592407283 0, 84.90084838867199 23.775587081909237 0, 84.9019393920899 23.78415107727045 0, 84.90488433837902 23.788919448852482 0, 84.90410614013683 23.79169654846197 0, 84.90534210205078 23.797201156616325 0, 84.90692901611334 23.800090789794922 0, 84.9098358154298 23.802299499511776 0, 84.91545867919922 23.804857254028377 0, 84.93749237060558 23.80261993408203 0, 84.94282531738293 23.80311584472662 0, 84.94415283203136 23.819328308105526 0, 84.94240570068365 23.82483291625971 0, 84.94553375244135 23.829368591308594 0, 84.94615936279297 23.835599899291992 0, 84.94558715820312 23.842861175537166 0, 84.94104003906256 23.853252410888615 0, 84.93069458007812 23.856519699096793 0, 84.92724609375 23.85891532897955 0, 84.92857360839844 23.862085342407283 0, 84.93212127685558 23.867008209228516 0, 84.93756103515625 23.870388031005973 0, 84.94401550292969 23.872400283813533 0, 84.94747161865234 23.874820709228516 0, 84.94746398925781 23.881950378417912 0, 84.94615173339844 23.882415771484432 0, 84.94370269775396 23.891931533813477 0, 84.93795776367188 23.90625381469738 0, 84.9327621459961 23.910921096801815 0, 84.92471313476574 23.91234588623047 0, 84.92445373535162 23.916017532348633 0, 84.92701721191418 23.92060852050787 0, 84.92813110351574 23.927614212036133 0, 84.9311981201173 23.931203842163143 0, 84.93305969238287 23.935302734375114 0, 84.93121337890636 23.94034004211437 0, 84.92298889160168 23.948160171508903 0, 84.92094421386719 23.951110839843807 0, 84.90414428710932 23.95059204101574 0, 84.8975677490235 23.948616027832088 0, 84.8921890258789 23.944913864135742 0, 84.8871841430664 23.94327735900879 0, 84.88565063476562 23.948434829711914 0, 84.88206481933594 23.952489852905273 0, 84.876937866211 23.95424461364746 0, 84.86927032470703 23.954183578491154 0, 84.86184692382812 23.95592689514166 0, 84.85037994384766 23.963655471801758 0, 84.84387969970703 23.965461730957145 0, 84.82823944091797 23.957931518554688 0, 84.82302093505871 23.971632003784237 0, 84.82334136962896 23.983791351318416 0, 84.81316375732416 23.979990005493278 0, 84.80782318115229 23.975944519043082 0, 84.80331420898443 23.970279693603572 0, 84.79751586914057 23.9716472625733 0, 84.79055023193365 23.969196319580192 0, 84.78271484375006 23.970174789428825 0, 84.77772521972656 23.969970703125057 0, 84.77217864990234 23.967216491699162 0, 84.76978302001959 23.966358184814396 0, 84.75714111328125 23.967525482177734 0, 84.75781250000011 23.969161987304688 0, 84.760009765625 23.969915390014705 0, 84.76387023925787 23.97573089599615 0, 84.7659301757813 23.97609710693365 0, 84.76674652099615 23.977207183838004 0, 84.76622772216808 23.978378295898494 0, 84.76445770263678 23.978796005248967 0, 84.76171875 23.978338241577205 0, 84.7578506469726 23.986484527587947 0, 84.76024627685553 23.991304397583008 0, 84.7679672241211 24.009141921997127 0, 84.76668548583984 24.012702941894588 0, 84.76111602783203 24.01678085327154 0, 84.75650024414074 24.027410507202262 0, 84.7499008178711 24.03260231018072 0, 84.74926757812494 24.034538269042912 0, 84.7521743774414 24.041744232177734 0, 84.7509155273438 24.04297256469738 0, 84.74457550048834 24.040121078491268 0, 84.74087524414057 24.048568725585994 0, 84.7371673583985 24.047216415405387 0, 84.73198699951178 24.043533325195312 0, 84.72752380371088 24.041484832763786 0, 84.71839904785156 24.044935226440543 0, 84.70761871337896 24.039691925048885 0, 84.70730590820307 24.03269767761236 0, 84.70960235595703 24.027370452880973 0, 84.6991195678711 24.023199081421012 0, 84.69151306152344 24.024604797363395 0, 84.68666839599621 24.02398109436041 0, 84.68286895751964 24.020343780517578 0, 84.67990875244146 24.01394844055187 0, 84.67591857910162 24.010389328002987 0, 84.67354583740229 24.004978179931697 0, 84.66863250732422 24.002227783203182 0, 84.66371154785162 24.00163078308117 0, 84.65953826904303 24.005342483520565 0, 84.6529006958009 24.007345199585018 0, 84.64470672607433 24.005672454833984 0, 84.63905334472656 23.998098373413086 0, 84.63537597656261 23.991247177124023 0, 84.62975311279303 23.98192977905279 0, 84.62724304199219 23.980739593505916 0, 84.62316131591808 23.982891082763786 0, 84.6205215454101 23.983875274658317 0, 84.61703491210949 23.984054565429688 0, 84.61360931396496 23.983062744140625 0, 84.60536193847662 23.989816665649414 0, 84.60430145263666 23.990055084228516 0, 84.59664916992199 23.98352432250971 0, 84.59095001220697 23.98710441589361 0, 84.58840942382818 23.98761558532715 0, 84.58347320556652 23.986732482910156 0, 84.58346557617199 23.98673057556158 0, 84.57415771484386 23.98570251464838 0, 84.57087707519543 23.984291076660213 0, 84.5684814453125 23.98533630371088 0, 84.56407165527344 23.991157531738338 0, 84.55693054199224 24.00307273864746 0, 84.5519409179688 24.016740798950252 0, 84.55463409423834 24.02729606628418 0, 84.5623779296875 24.03343009948736 0, 84.55928802490229 24.037521362304744 0, 84.55213928222662 24.043951034545955 0, 84.5514373779298 24.050067901611442 0, 84.56203460693365 24.052591323852596 0, 84.56495666503918 24.056041717529297 0, 84.5727157592774 24.070903778076172 0, 84.56117248535168 24.078142166137695 0, 84.55175018310553 24.103799819946403 0, 84.56279754638678 24.11651802062994 0, 84.5702743530274 24.11849403381359 0, 84.578109741211 24.141965866088924 0, 84.55001831054693 24.153587341308594 0, 84.54776000976568 24.160974502563533 0, 84.54298400878912 24.1685409545899 0, 84.53643798828125 24.171216964721793 0, 84.53301239013672 24.177978515624943 0, 84.52980804443365 24.181272506713924 0, 84.52632141113281 24.19176483154297 0, 84.53531646728516 24.19944572448742 0, 84.53446197509777 24.203474044799748 0, 84.52680969238293 24.207365036010742 0, 84.5190658569336 24.2000350952149 0, 84.50898742675781 24.201164245605526 0, 84.49946594238281 24.200004577636776 0, 84.486557006836 24.201789855957145 0, 84.47439575195324 24.207529067993278 0, 84.47118377685547 24.210647583007812 0, 84.47219848632818 24.21991539001465 0, 84.47142028808594 24.229227066040096 0, 84.46715545654308 24.232011795043945 0, 84.44645690917974 24.23945236206066 0, 84.44274902343744 24.244115829467717 0, 84.4542846679688 24.26144790649414 0, 84.45553588867182 24.26811408996582 0, 84.46499633789068 24.265716552734318 0, 84.46958923339855 24.26829338073742 0, 84.47080993652344 24.26627731323248 0, 84.46826934814464 24.26300239562994 0, 84.4640579223634 24.259681701660213 0, 84.48188018798828 24.26301383972168 0, 84.48659515380871 24.26466751098627 0, 84.48629760742188 24.27018928527832 0, 84.48346710205084 24.276580810546818 0, 84.49885559082031 24.287418365478516 0, 84.50221252441418 24.293090820312557 0, 84.50761413574219 24.29491806030279 0, 84.50656127929693 24.29918098449707 0, 84.50986480712902 24.30625343322754 0, 84.50852203369152 24.315752029418945 0, 84.51602172851562 24.317518234253043 0, 84.51950073242193 24.32395362854004 0, 84.52274322509771 24.334011077880916 0, 84.53081512451183 24.339807510375977 0, 84.52470397949224 24.346153259277457 0, 84.52414703369152 24.353466033935604 0, 84.53204345703125 24.361328125 0, 84.53329467773449 24.365131378173942 0, 84.52938842773438 24.36905288696289 0, 84.52686309814447 24.37654304504406 0, 84.54701995849615 24.377002716064396 0, 84.55117034912115 24.374006271362248 0, 84.56137084960949 24.38001632690441 0, 84.57111358642572 24.384246826171932 0, 84.56964111328125 24.390182495117244 0, 84.56444549560541 24.397396087646598 0, 84.56655883789062 24.402114868164062 0, 84.5707244873048 24.407743453979606 0, 84.57781982421875 24.412618637085018 0, 84.58538818359386 24.410696029663143 0, 84.587158203125 24.401760101318473 0, 84.59523773193365 24.404670715332088 0, 84.59951782226574 24.40431213378912 0, 84.60626220703125 24.401288986206055 0, 84.61782073974621 24.401535034179688 0, 84.62049102783214 24.40412330627447 0, 84.62458038330078 24.402378082275334 0, 84.62818908691406 24.404268264770508 0, 84.6341400146485 24.400501251220703 0, 84.64833068847668 24.398950576782227 0, 84.66352844238287 24.394102096557674 0, 84.66539764404297 24.396345138549805 0, 84.66822814941406 24.410955429077262 0, 84.67307281494146 24.413301467895565 0, 84.67367553710949 24.426607131958008 0, 84.67113494873053 24.428752899169922 0, 84.6715087890625 24.431507110595817 0, 84.67930603027344 24.441448211670036 0, 84.68419647216808 24.456640243530273 0, 84.68936157226574 24.45949745178234 0, 84.69936370849615 24.462102890014762 0, 84.71181488037115 24.472656249999943 0, 84.71819305419922 24.468935012817383 0, 84.72278594970703 24.46913909912115 0, 84.73019409179682 24.473253250122184 0, 84.74533843994146 24.488574981689396 0, 84.74729156494146 24.496761322021598 0, 84.76824188232428 24.502069473266545 0, 84.78514862060547 24.50515556335455 0, 84.78892517089855 24.518005371093864 0, 84.79496002197271 24.52184677124029 0, 84.80058288574219 24.52978324890148 0), (84.49883270263666 24.265573501586857 0, 84.50148010253918 24.263549804687557 0, 84.50512695312494 24.263704299926758 0, 84.50794982910168 24.26594161987316 0, 84.50891876220714 24.268964767456055 0, 84.50690460205078 24.273151397705135 0, 84.50524139404303 24.27777481079113 0, 84.50283813476557 24.282361984252987 0, 84.49911499023443 24.283924102783146 0, 84.49694061279297 24.283407211303654 0, 84.4952621459961 24.27993392944336 0, 84.4946517944336 24.277347564697322 0, 84.49684143066412 24.269334793090934 0, 84.49883270263666 24.265573501586857 0))",both
KODARMA,717169,367952,349217,427,"POLYGON Z ((85.38822937011713 24.53589248657221 0, 85.39344024658203 24.537776947021598 0, 85.40001678466808 24.54197120666504 0, 85.40790557861328 24.545625686645508 0, 85.41145324707043 24.546348571777344 0, 85.41587829589838 24.54579925537115 0, 85.432357788086 24.538011550903377 0, 85.43808746337896 24.536806106567383 0, 85.44711303710949 24.540168762206974 0, 85.45136260986322 24.54070854187006 0, 85.4613876342774 24.539939880371207 0, 85.47694396972656 24.548522949218864 0, 85.48573303222656 24.548858642578182 0, 85.49127197265625 24.551486968994254 0, 85.49421691894543 24.549890518188533 0, 85.49922943115229 24.551361083984432 0, 85.5022964477539 24.549247741699276 0, 85.50225830078136 24.547626495361385 0, 85.50474548339855 24.544641494750977 0, 85.50731658935553 24.543634414672965 0, 85.50795745849621 24.536491394043026 0, 85.50718688964855 24.532199859619197 0, 85.50912475585949 24.530506134033317 0, 85.51956939697271 24.528617858886776 0, 85.52305603027355 24.525335311889705 0, 85.53892517089844 24.53298377990717 0, 85.5411987304687 24.536798477172795 0, 85.54509735107428 24.55110359191889 0, 85.54462432861322 24.556907653808707 0, 85.5429458618164 24.562204360961914 0, 85.54122161865234 24.564546585083065 0, 85.54155731201183 24.565996170043945 0, 85.54377746582037 24.56661605834961 0, 85.54856109619146 24.56523323059082 0, 85.55707550048828 24.56017494201666 0, 85.55935668945312 24.55690002441412 0, 85.56100463867199 24.55758857727045 0, 85.56132507324224 24.56141281127941 0, 85.56918334960949 24.562622070312557 0, 85.57302856445324 24.565958023071403 0, 85.5704956054688 24.57242012023937 0, 85.57186126708996 24.578971862793026 0, 85.56697082519531 24.581737518310604 0, 85.56613922119152 24.584419250488224 0, 85.5675888061524 24.592008590698185 0, 85.56995391845714 24.59738922119135 0, 85.57463073730469 24.6009464263916 0, 85.58132171630865 24.603736877441406 0, 85.58670043945318 24.600839614868278 0, 85.59587860107433 24.59779930114746 0, 85.60296630859386 24.598316192626953 0, 85.61258697509766 24.591560363769588 0, 85.61324310302746 24.58580780029297 0, 85.6201553344726 24.583709716796875 0, 85.6266860961914 24.58464431762701 0, 85.63748931884777 24.581350326538086 0, 85.6489639282226 24.579099655151367 0, 85.6693725585937 24.58273887634283 0, 85.67498016357428 24.58889579772955 0, 85.67790985107433 24.59374427795416 0, 85.67820739746094 24.596416473388672 0, 85.67705535888672 24.598978042602482 0, 85.67524719238293 24.60021781921381 0, 85.67680358886713 24.620166778564567 0, 85.6736450195313 24.63128471374523 0, 85.67040252685553 24.637008666992244 0, 85.66902923583984 24.641773223876953 0, 85.66833496093756 24.645206451416016 0, 85.66590118408214 24.647373199462947 0, 85.66541290283203 24.651329040527457 0, 85.6684341430664 24.661691665649528 0, 85.66806030273438 24.665410995483512 0, 85.66551971435558 24.668281555175838 0, 85.6644897460938 24.671010971069336 0, 85.66469573974615 24.67542839050293 0, 85.65522766113293 24.67992591857916 0, 85.65299224853516 24.682556152343807 0, 85.65428161621105 24.687711715698356 0, 85.68438720703136 24.694456100463867 0, 85.69178771972662 24.70158195495611 0, 85.70137786865246 24.71414375305187 0, 85.70111846923834 24.71791648864746 0, 85.70346832275402 24.721729278564453 0, 85.70816802978521 24.7260360717774 0, 85.70949554443365 24.72938346862793 0, 85.71007537841803 24.74069786071783 0, 85.7128677368164 24.74833106994629 0, 85.71028137207037 24.75225257873541 0, 85.70829772949219 24.75807189941412 0, 85.70822143554699 24.764108657837028 0, 85.70951843261724 24.769435882568416 0, 85.71394348144543 24.776245117187557 0, 85.71455383300793 24.78158187866211 0, 85.7170639038086 24.783933639526367 0, 85.72573089599615 24.787565231323242 0, 85.72772216796886 24.79949760437023 0, 85.7330703735351 24.801248550415096 0, 85.7345428466798 24.80906677246105 0, 85.7372817993164 24.81705093383789 0, 85.73977661132812 24.82195281982422 0, 85.74150848388672 24.823221206665153 0, 85.7520370483399 24.820495605468807 0, 85.76301574707026 24.815679550170955 0, 85.76548767089855 24.815654754638786 0, 85.77017974853521 24.813110351562443 0, 85.77352142333984 24.8094100952149 0, 85.77331542968744 24.804651260375977 0, 85.77412414550781 24.80348205566412 0, 85.78195190429688 24.799568176269474 0, 85.78395080566418 24.801113128662166 0, 85.79043579101574 24.79930686950695 0, 85.81534576416016 24.795146942138672 0, 85.81727600097662 24.79999923706066 0, 85.8227310180664 24.807600021362305 0, 85.82726287841808 24.809577941894588 0, 85.83190155029297 24.810272216796875 0, 85.84661102294922 24.80871772766119 0, 85.8584594726563 24.80829429626459 0, 85.86868286132807 24.806095123291072 0, 85.88242340087885 24.800970077514705 0, 85.8943099975586 24.792345046997184 0, 85.89181518554688 24.786293029785156 0, 85.90628051757812 24.770584106445256 0, 85.9091567993164 24.76202011108404 0, 85.89934539794933 24.756843566894474 0, 85.8996353149414 24.755794525146428 0, 85.89827728271484 24.754409790039062 0, 85.89530181884771 24.755073547363338 0, 85.8885498046875 24.75449943542492 0, 85.88758087158203 24.748628616333065 0, 85.89288330078136 24.741958618164176 0, 85.892807006836 24.73927879333496 0, 85.8912124633789 24.736268997192496 0, 85.88256835937511 24.738965988159237 0, 85.8746566772461 24.74048995971691 0, 85.86314392089855 24.738920211791992 0, 85.86034393310547 24.74214744567871 0, 85.85568237304699 24.742946624755916 0, 85.85266876220697 24.738628387451115 0, 85.84541320800776 24.739280700683707 0, 85.83658599853527 24.737871170043945 0, 85.82799530029303 24.73552322387701 0, 85.82012176513678 24.730209350585938 0, 85.81764221191412 24.722867965698242 0, 85.8187866210938 24.71641159057623 0, 85.82483673095703 24.711931228637695 0, 85.8267059326173 24.7067546844483 0, 85.82761383056646 24.698793411254883 0, 85.83068084716808 24.693422317504883 0, 85.83161163330084 24.686159133911133 0, 85.8348236083985 24.685251235961914 0, 85.8350448608399 24.680374145507756 0, 85.83984375000011 24.673191070556754 0, 85.83879089355469 24.670932769775334 0, 85.83182525634777 24.670194625854606 0, 85.82576751708979 24.667940139770565 0, 85.80762481689464 24.674394607544002 0, 85.79882812500011 24.673671722412166 0, 85.79326629638678 24.670310974121094 0, 85.78794097900396 24.665781021118164 0, 85.78396606445324 24.65960693359375 0, 85.7830047607423 24.652133941650447 0, 85.77774047851562 24.647720336914176 0, 85.77284240722662 24.639413833618107 0, 85.76414489746105 24.629863739013786 0, 85.76249694824219 24.62645149230957 0, 85.76535034179688 24.61679458618164 0, 85.76921844482428 24.614257812500057 0, 85.77490234375 24.613565444946346 0, 85.7840347290039 24.609180450439453 0, 85.78780364990246 24.608091354370117 0, 85.80135345458979 24.613182067871207 0, 85.79920196533214 24.609256744384822 0, 85.79442596435553 24.604143142700195 0, 85.79230499267584 24.599231719970703 0, 85.79230499267584 24.592500686645508 0, 85.79966735839844 24.580640792846737 0, 85.80458068847668 24.57670402526867 0, 85.80350494384766 24.56957626342779 0, 85.80455017089855 24.565212249755973 0, 85.80248260498058 24.55920219421381 0, 85.80593109130854 24.558067321777457 0, 85.80766296386719 24.55305099487299 0, 85.80997467041016 24.55181503295904 0, 85.8148880004884 24.55106735229498 0, 85.82347106933605 24.550918579101562 0, 85.83386230468756 24.549480438232422 0, 85.83792877197277 24.547868728637695 0, 85.85123443603521 24.54006767272955 0, 85.8642959594726 24.530244827270565 0, 85.86563110351557 24.527328491210994 0, 85.86174774169928 24.513442993164176 0, 85.86446380615246 24.503547668456974 0, 85.86047363281261 24.490303039550838 0, 85.8511962890625 24.469221115112305 0, 85.84870910644531 24.46727561950678 0, 85.84635162353527 24.463586807250977 0, 85.84130096435553 24.460212707519645 0, 85.83679962158214 24.455966949462834 0, 85.82980346679688 24.45030212402355 0, 85.82948303222662 24.446994781494084 0, 85.83391571044933 24.43221092224121 0, 85.83551025390625 24.429988861084098 0, 85.83901214599615 24.4283905029298 0, 85.8506469726563 24.420557022094783 0, 85.84674072265636 24.411479949951286 0, 85.8470306396485 24.40764999389654 0, 85.84993743896496 24.401470184326172 0, 85.84779357910162 24.39557456970215 0, 85.84847259521479 24.391679763793945 0, 85.84542083740229 24.381799697876033 0, 85.84900665283214 24.3782196044923 0, 85.84795379638672 24.37336349487316 0, 85.85018920898432 24.368232727050838 0, 85.84606933593756 24.3617782592774 0, 85.84510803222662 24.358015060424805 0, 85.84241485595703 24.353174209594727 0, 85.84236145019526 24.3477783203125 0, 85.84796142578125 24.34129142761236 0, 85.8490371704101 24.33594131469738 0, 85.8526840209961 24.33538055419922 0, 85.8576126098634 24.335733413696403 0, 85.86125183105463 24.334768295288086 0, 85.86391448974604 24.335382461547795 0, 85.86563110351557 24.330375671386662 0, 85.86551666259771 24.32550430297846 0, 85.86411285400385 24.321865081787223 0, 85.86443328857433 24.319139480590934 0, 85.86680603027344 24.317836761474723 0, 85.86612701416021 24.312860488891545 0, 85.86911010742188 24.30557441711437 0, 85.8675537109375 24.300437927246094 0, 85.8676147460938 24.295278549194336 0, 85.85791778564459 24.29264640808111 0, 85.85521697998053 24.287630081176815 0, 85.85443115234375 24.283588409423828 0, 85.84875488281256 24.277900695800895 0, 85.8309326171875 24.26434516906744 0, 85.83234405517584 24.26004600524908 0, 85.83704376220703 24.25906944274908 0, 85.84259033203125 24.259244918823242 0, 85.84652709960949 24.25810623168951 0, 85.84817504882818 24.255300521850643 0, 85.85327911376953 24.24221420288086 0, 85.85305786132812 24.235836029052848 0, 85.8509750366211 24.230295181274414 0, 85.85033416748058 24.224740982055607 0, 85.85468292236334 24.21977615356451 0, 85.85129547119152 24.21789932250988 0, 85.84774780273438 24.219324111938533 0, 85.84394836425781 24.2234725952149 0, 85.84189605712896 24.224426269531307 0, 85.83318328857433 24.223354339599666 0, 85.8255767822265 24.22406959533697 0, 85.81724548339844 24.22032546997076 0, 85.81542968750011 24.21808624267578 0, 85.80884552001953 24.224521636962947 0, 85.8048095703125 24.226997375488224 0, 85.79846954345714 24.232563018798942 0, 85.79591369628912 24.230672836303768 0, 85.79077911376959 24.221450805664006 0, 85.7808685302735 24.217088699340934 0, 85.77017974853521 24.21440505981451 0, 85.76232910156256 24.21754455566412 0, 85.75527954101568 24.211175918579215 0, 85.74622344970714 24.20841407775879 0, 85.74038696289062 24.208124160766715 0, 85.736572265625 24.206586837768555 0, 85.72948455810547 24.20664787292486 0, 85.72959899902355 24.203052520751896 0, 85.72794342041016 24.198719024658203 0, 85.7233123779298 24.196435928344783 0, 85.70977020263683 24.193586349487305 0, 85.67643737792969 24.18335342407238 0, 85.67313385009777 24.174009323120174 0, 85.67245483398438 24.16789054870611 0, 85.6709823608399 24.161836624145508 0, 85.66761779785168 24.15661239624029 0, 85.67640686035168 24.149612426757812 0, 85.68630218505871 24.14566421508789 0, 85.69941711425787 24.135843276977653 0, 85.70554351806646 24.130611419677734 0, 85.71019744873047 24.124410629272518 0, 85.70741271972662 24.119779586791992 0, 85.70766448974621 24.11504745483404 0, 85.70567321777344 24.1056365966798 0, 85.71285247802729 24.105268478393555 0, 85.71582031250006 24.10366058349615 0, 85.72449493408197 24.1034774780274 0, 85.7281723022461 24.100639343261776 0, 85.7158660888673 24.087837219238338 0, 85.70779418945318 24.082332611083984 0, 85.69773101806652 24.08178520202631 0, 85.68462371826166 24.080429077148494 0, 85.6735305786134 24.083879470825252 0, 85.65986633300781 24.090467453002987 0, 85.64220428466803 24.102169036865234 0, 85.62893676757807 24.110958099365234 0, 85.61501312255854 24.11616706848156 0, 85.60943603515636 24.117292404174805 0, 85.60330200195318 24.11705589294445 0, 85.59198760986328 24.120141983032283 0, 85.58402252197271 24.124025344848746 0, 85.57948303222668 24.123546600341797 0, 85.5696868896485 24.12906265258789 0, 85.55623626708996 24.137571334838924 0, 85.5374603271485 24.15040969848627 0, 85.5288925170899 24.156707763671932 0, 85.5158920288086 24.160217285156364 0, 85.49908447265625 24.161741256713867 0, 85.491455078125 24.16431808471691 0, 85.489242553711 24.171308517456055 0, 85.48992156982422 24.17543029785162 0, 85.49446105957026 24.18061256408697 0, 85.50623321533214 24.19101524353033 0, 85.51190948486334 24.196481704712028 0, 85.51548767089844 24.209529876708928 0, 85.52093505859386 24.21716690063471 0, 85.54145050048828 24.23172378540039 0, 85.55594635009766 24.240360260009822 0, 85.5743026733399 24.252466201782227 0, 85.59935760498058 24.28095054626465 0, 85.60543060302746 24.29114151000988 0, 85.61788177490234 24.299995422363395 0, 85.62504577636724 24.30747222900385 0, 85.61633300781261 24.312860488891545 0, 85.6048202514649 24.318717956543082 0, 85.58579254150402 24.329914093017578 0, 85.56780242919928 24.337017059326172 0, 85.55548095703136 24.33820152282715 0, 85.54647827148449 24.33235168457037 0, 85.53446197509777 24.321727752685547 0, 85.51922607421886 24.318313598632926 0, 85.5114974975586 24.32098579406744 0, 85.49112701416021 24.324203491210994 0, 85.46702575683594 24.325309753418026 0, 85.45940399169922 24.325519561767578 0, 85.43846893310553 24.329854965210018 0, 85.42056274414068 24.336845397949162 0, 85.41178894042974 24.338811874389705 0, 85.40895080566412 24.338174819946346 0, 85.40039062500011 24.328340530395508 0, 85.39217376708996 24.32171821594244 0, 85.3841171264649 24.309469223022518 0, 85.380111694336 24.297815322875977 0, 85.3713150024414 24.289278030395508 0, 85.36343383789057 24.285959243774528 0, 85.34540557861334 24.285022735595817 0, 85.33301544189459 24.28692626953125 0, 85.33370208740234 24.291534423828182 0, 85.33119964599604 24.303852081298885 0, 85.32391357421886 24.31000137329113 0, 85.30496215820318 24.318580627441406 0, 85.2794876098634 24.324354171753043 0, 85.26439666748058 24.326028823852482 0, 85.24358367919928 24.328193664550838 0, 85.23412322998047 24.329671859741268 0, 85.21638488769531 24.32846260070812 0, 85.19314575195312 24.322883605957145 0, 85.18022918701178 24.319795608520508 0, 85.1741561889649 24.326173782348746 0, 85.16870880126953 24.333036422729492 0, 85.16255187988293 24.34020042419445 0, 85.15587615966808 24.344385147094727 0, 85.14981842041016 24.343667984008846 0, 85.14385986328136 24.34064292907715 0, 85.11126708984386 24.320077896118278 0, 85.09911346435547 24.31781005859375 0, 85.09189605712896 24.32090568542486 0, 85.08992767333984 24.32456398010254 0, 85.08978271484375 24.329399108886832 0, 85.08930969238293 24.344577789306584 0, 85.08808135986334 24.346460342407227 0, 85.08261108398449 24.35576248168951 0, 85.08179473876959 24.365556716918945 0, 85.0856323242188 24.381444931030217 0, 85.08566284179699 24.381431579589957 0, 85.09440612792974 24.379882812500057 0, 85.09744262695318 24.38220787048334 0, 85.10092926025402 24.3914470672608 0, 85.10363769531261 24.39459800720209 0, 85.1143035888673 24.399494171142692 0, 85.1200408935548 24.409692764282283 0, 85.1239624023438 24.409807205200195 0, 85.12565612792974 24.409111022949332 0, 85.13189697265625 24.41218757629406 0, 85.15292358398438 24.418867111206055 0, 85.16025543212902 24.418699264526367 0, 85.1628189086914 24.42483329772955 0, 85.16933441162115 24.428367614746207 0, 85.17432403564459 24.43015098571783 0, 85.17378997802746 24.432464599609375 0, 85.17121887207031 24.434156417846737 0, 85.16979217529308 24.43647003173828 0, 85.16868591308588 24.442090988159123 0, 85.16629791259771 24.443946838378963 0, 85.16370391845714 24.45189285278326 0, 85.15757751464855 24.454395294189567 0, 85.1548919677735 24.45648574829113 0, 85.15425109863281 24.459905624389705 0, 85.15564727783209 24.463495254516715 0, 85.15788269042969 24.46476554870617 0, 85.16821289062506 24.4678249359132 0, 85.17246246337902 24.467994689941463 0, 85.17484283447266 24.4667205810548 0, 85.18128204345697 24.468614578247127 0, 85.18756866455072 24.46930313110363 0, 85.19548797607428 24.46922302246088 0, 85.2042007446289 24.468046188354492 0, 85.20819854736328 24.473600387573242 0, 85.22072601318371 24.47320747375494 0, 85.22887420654303 24.471851348876953 0, 85.23347473144537 24.480070114135742 0, 85.2402572631836 24.480506896972656 0, 85.24436950683605 24.48947334289562 0, 85.25142669677746 24.49593544006359 0, 85.25936889648443 24.498579025268555 0, 85.27449035644543 24.49903106689453 0, 85.28687286376959 24.497873306274357 0, 85.28596496582043 24.50042533874523 0, 85.2872772216798 24.504421234130803 0, 85.28685760498053 24.509819030761832 0, 85.28471374511719 24.51452445983898 0, 85.28427886962885 24.519737243652457 0, 85.2874374389649 24.52732276916504 0, 85.29296112060553 24.52903556823742 0, 85.30226135253906 24.529279708862305 0, 85.31741333007824 24.527233123779354 0, 85.3234481811524 24.525287628173885 0, 85.327392578125 24.526252746581974 0, 85.33644104003912 24.52690315246582 0, 85.34279632568371 24.528661727905387 0, 85.35070037841797 24.528675079345703 0, 85.3660278320313 24.53038597106945 0, 85.37512969970703 24.53026962280279 0, 85.38763427734386 24.533216476440543 0, 85.38822937011713 24.53589248657221 0))",both
GIRIDIH,2445203,1258607,1186596,497,"POLYGON Z ((85.9091567993164 24.76202011108404 0, 85.91510009765625 24.754417419433594 0, 85.92552947998041 24.745330810546932 0, 85.93223571777344 24.74127960205078 0, 85.94723510742199 24.735214233398494 0, 85.95484161376964 24.732919692993164 0, 85.96517181396496 24.732509613037223 0, 85.97064971923834 24.733093261718807 0, 85.97469329833996 24.734390258789062 0, 85.97724151611328 24.737098693847713 0, 85.98040771484386 24.746767044067496 0, 85.98178100585949 24.748437881469783 0, 86.00448608398432 24.752178192138615 0, 86.01061248779297 24.766469955444393 0, 86.01408386230469 24.768783569335994 0, 86.0184936523438 24.769792556762752 0, 86.02417755126953 24.768556594848633 0, 86.02723693847656 24.77017211914074 0, 86.03227996826183 24.771089553833065 0, 86.03628540039074 24.77354621887207 0, 86.03895568847668 24.776966094970646 0, 86.04347991943365 24.777463912963867 0, 86.04753112792974 24.778196334838867 0, 86.05235290527355 24.77909278869629 0, 86.05506134033203 24.780338287353572 0, 86.05709838867199 24.773994445800895 0, 86.0573501586914 24.768524169921875 0, 86.05747985839855 24.762573242187443 0, 86.05431365966797 24.756605148315373 0, 86.04981994628912 24.752735137939567 0, 86.04602050781261 24.748735427856445 0, 86.04048156738293 24.74817276000971 0, 86.04129028320324 24.744659423828125 0, 86.04354095458996 24.742153167724666 0, 86.04717254638683 24.744707107543945 0, 86.05949401855474 24.7471923828125 0, 86.0648803710938 24.748525619506893 0, 86.0676498413086 24.752504348754826 0, 86.09099578857428 24.747190475463924 0, 86.1099319458009 24.73684883117687 0, 86.1137084960938 24.733121871948356 0, 86.11532592773438 24.724927902221793 0, 86.12035369873053 24.71978187561041 0, 86.123031616211 24.712564468383846 0, 86.12879943847668 24.706090927124023 0, 86.13346099853516 24.690979003906307 0, 86.1363525390625 24.68134307861328 0, 86.13795471191418 24.676473617553825 0, 86.13436126708996 24.672431945800838 0, 86.13030242919928 24.671770095825252 0, 86.13283538818371 24.666948318481502 0, 86.13064575195318 24.655206680297965 0, 86.12747955322277 24.648927688598746 0, 86.1225814819336 24.642889022827262 0, 86.12618255615229 24.631067276000977 0, 86.12632751464855 24.624946594238338 0, 86.12754821777344 24.620714187622013 0, 86.12992095947271 24.61285018920904 0, 86.1350708007813 24.60997390747076 0, 86.13758850097668 24.604583740234432 0, 86.14891052246094 24.604104995727653 0, 86.15653991699219 24.6007595062257 0, 86.16125488281261 24.590312957763672 0, 86.16991424560547 24.584766387939453 0, 86.19917297363293 24.586263656616325 0, 86.21994781494146 24.59227371215826 0, 86.22079467773438 24.603893280029354 0, 86.22162628173834 24.612852096557617 0, 86.23448181152355 24.60336875915533 0, 86.24295806884766 24.597913742065373 0, 86.24707031250011 24.593248367309513 0, 86.25272369384771 24.586259841918945 0, 86.26166534423828 24.58427238464361 0, 86.26570129394537 24.57804298400879 0, 86.26830291748047 24.57698631286621 0, 86.27042388916016 24.583087921142635 0, 86.27385711669922 24.57895088195795 0, 86.27763366699219 24.576780319213867 0, 86.28104400634777 24.57536125183117 0, 86.28028106689464 24.580228805541992 0, 86.27795410156261 24.5838947296142 0, 86.28456115722662 24.58532905578619 0, 86.29251861572266 24.585487365722713 0, 86.29676818847662 24.587238311767578 0, 86.30581665039074 24.584314346313477 0, 86.31419372558605 24.582725524902344 0, 86.31635284423828 24.587039947509766 0, 86.3269729614259 24.58525848388672 0, 86.32680511474621 24.58173561096197 0, 86.32268524169922 24.580091476440487 0, 86.32350921630865 24.575639724731502 0, 86.31510925292974 24.56936073303234 0, 86.31222534179693 24.56690216064453 0, 86.31394195556646 24.564283370971737 0, 86.30817413330078 24.5594806671142 0, 86.313949584961 24.548551559448242 0, 86.31227111816412 24.542039871215877 0, 86.30545806884777 24.533201217651424 0, 86.30740356445312 24.52895545959484 0, 86.31161499023438 24.527585983276367 0, 86.31465148925781 24.515064239502067 0, 86.31651306152355 24.509725570678768 0, 86.31381988525402 24.507617950439567 0, 86.30758666992188 24.499530792236385 0, 86.30572509765625 24.494802474975586 0, 86.3023300170899 24.49027442932129 0, 86.3018264770509 24.48380088806158 0, 86.29797363281261 24.477710723876896 0, 86.28965759277344 24.478080749511776 0, 86.28592681884771 24.471763610839844 0, 86.28322601318365 24.463291168212947 0, 86.30496215820312 24.45810699462902 0, 86.30288696289068 24.455575942993164 0, 86.30364227294928 24.450313568115234 0, 86.30781555175781 24.44616317749029 0, 86.31959533691406 24.44524383544922 0, 86.3235321044923 24.441503524780387 0, 86.33674621582026 24.441535949707145 0, 86.35183715820312 24.441846847534293 0, 86.35472869873047 24.445053100585938 0, 86.35749816894543 24.443408966064453 0, 86.36670684814453 24.428169250488395 0, 86.37187957763672 24.4256267547608 0, 86.37725067138672 24.41724777221674 0, 86.38520812988281 24.413751602172965 0, 86.40264129638678 24.40171051025385 0, 86.40494537353521 24.397703170776367 0, 86.41950988769543 24.38066673278803 0, 86.42904663085949 24.37958335876465 0, 86.43460083007807 24.37760734558117 0, 86.4380264282226 24.378328323364258 0, 86.45020294189464 24.369924545288143 0, 86.45608520507818 24.370113372802848 0, 86.45644378662115 24.36881446838379 0, 86.4574432373048 24.365245819091797 0, 86.45645141601568 24.36052322387701 0, 86.45751190185547 24.35630035400385 0, 86.46127319335949 24.354633331298942 0, 86.46720123291027 24.353061676025447 0, 86.46793365478527 24.351724624633903 0, 86.46724700927734 24.347579956054688 0, 86.46485137939459 24.343852996826172 0, 86.4629592895509 24.341394424438533 0, 86.46037292480469 24.337839126587028 0, 86.46136474609375 24.33337974548334 0, 86.46723937988281 24.33203697204584 0, 86.47013092041016 24.330444335937557 0, 86.47307586669933 24.328386306762695 0, 86.47267150878912 24.32112121582037 0, 86.47196197509777 24.31390953063959 0, 86.47457885742193 24.310932159423885 0, 86.47608184814459 24.30692672729498 0, 86.47662353515625 24.302131652831974 0, 86.47949218750006 24.298112869262752 0, 86.48473358154308 24.296550750732422 0, 86.4862518310548 24.289827346801758 0, 86.48850250244146 24.28691482543951 0, 86.4932479858399 24.284658432006893 0, 86.49923706054699 24.283718109130973 0, 86.5046157836914 24.28267478942871 0, 86.50724029541027 24.275598526001033 0, 86.50833892822271 24.269983291625977 0, 86.51049804687511 24.264354705810604 0, 86.51129150390625 24.25914573669445 0, 86.51078796386724 24.249044418335075 0, 86.51318359374994 24.243530273437614 0, 86.51467132568371 24.238603591919002 0, 86.50997924804688 24.23456764221197 0, 86.51114654541016 24.22987174987793 0, 86.51551818847656 24.22340583801264 0, 86.51090240478516 24.21619033813488 0, 86.50978088378906 24.206853866577205 0, 86.505844116211 24.202917098998967 0, 86.5023193359375 24.199031829834098 0, 86.50371551513678 24.192089080810604 0, 86.50303649902355 24.1837158203125 0, 86.49810028076183 24.175348281860295 0, 86.49374389648438 24.163455963134822 0, 86.48697662353521 24.15256118774414 0, 86.49599456787121 24.15112686157238 0, 86.50185394287115 24.14989662170416 0, 86.50683593750011 24.148220062255916 0, 86.51309204101568 24.14820289611822 0, 86.51829528808605 24.1498641967774 0, 86.52306365966808 24.15367698669445 0, 86.5255737304687 24.156826019287166 0, 86.52957153320324 24.15532684326172 0, 86.54098510742199 24.1527042388916 0, 86.54653167724621 24.151416778564453 0, 86.55245208740246 24.15457725524908 0, 86.56362152099615 24.1481990814209 0, 86.57339477539074 24.140657424926758 0, 86.56813049316406 24.140005111694336 0, 86.56560516357433 24.135595321655273 0, 86.5651473999024 24.127500534057674 0, 86.56183624267578 24.1240234375 0, 86.55872344970714 24.112148284912166 0, 86.55583190917974 24.102790832519645 0, 86.5533294677735 24.09978103637701 0, 86.54946899414062 24.0969562530517 0, 86.54568481445318 24.085763931274414 0, 86.54502868652338 24.0774822235108 0, 86.54155731201183 24.072961807250977 0, 86.53626251220697 24.069276809692496 0, 86.53307342529297 24.063491821289176 0, 86.53060913085943 24.05710792541504 0, 86.51893615722656 24.05380439758312 0, 86.51353454589855 24.052173614501896 0, 86.5047225952149 24.0502872467041 0, 86.49686431884771 24.045038223266715 0, 86.49098968505865 24.045963287353572 0, 86.48696899414068 24.044664382934684 0, 86.48149871826183 24.044639587402287 0, 86.47799682617193 24.034938812255916 0, 86.47859954833996 24.026556015014705 0, 86.48450469970709 24.02995681762701 0, 86.48444366455078 24.023983001708984 0, 86.47930145263678 24.022640228271484 0, 86.47239685058594 24.020721435546932 0, 86.46858215332031 24.018484115600586 0, 86.4616928100586 24.019947052001896 0, 86.45519256591791 24.02284240722662 0, 86.4488143920899 24.027994155883846 0, 86.44379425048828 24.03082084655773 0, 86.43857574462902 24.0319766998291 0, 86.43222045898443 24.03110885620123 0, 86.42561340332043 24.029954910278434 0, 86.42156982421886 24.030467987060547 0, 86.41235351562506 24.035406112671012 0, 86.40392303466797 24.038436889648494 0, 86.39647674560547 24.04102897644043 0, 86.39098358154297 24.048456192016715 0, 86.38833618164068 24.055089950561467 0, 86.38498687744152 24.05950546264654 0, 86.37991333007812 24.06011199951172 0, 86.37516784667974 24.059104919433707 0, 86.37080383300787 24.05402374267578 0, 86.3663940429688 24.05121994018549 0, 86.35832214355469 24.051818847656307 0, 86.35185241699219 24.054325103759766 0, 86.3469848632813 24.05596351623535 0, 86.34162139892584 24.05502891540533 0, 86.33438110351568 24.052848815917912 0, 86.33597564697277 24.050315856933707 0, 86.33357238769531 24.047361373901424 0, 86.33419799804693 24.04321670532221 0, 86.33290100097668 24.042139053344783 0, 86.32811737060558 24.040994644165096 0, 86.3202514648438 24.037990570068416 0, 86.31931304931646 24.03623962402355 0, 86.32125091552746 24.034616470336914 0, 86.32429504394543 24.033142089843807 0, 86.32720184326183 24.030296325683707 0, 86.33057403564459 24.028875350952205 0, 86.33525848388672 24.028224945068416 0, 86.34002685546875 24.027196884155387 0, 86.34053802490246 24.024114608764705 0, 86.34020233154297 24.02161026000988 0, 86.33821868896496 24.019197463989258 0, 86.33367919921886 24.01845932006836 0, 86.32985687255871 24.016872406005973 0, 86.32588195800776 24.01379776000988 0, 86.3240585327149 24.011362075805664 0, 86.32092285156244 24.00704574584961 0, 86.31315612792969 23.998170852661133 0, 86.30290985107428 23.990951538085994 0, 86.30088043212902 23.984514236450252 0, 86.30280303955072 23.97834396362316 0, 86.30057525634766 23.97480201721197 0, 86.29856872558605 23.9672794342041 0, 86.28781127929693 23.946392059326172 0, 86.29046630859375 23.91475486755371 0, 86.27751159667974 23.933578491210994 0, 86.2722625732423 23.93272209167486 0, 86.26667785644537 23.93017005920416 0, 86.26048278808594 23.930534362793082 0, 86.25675201416021 23.931808471679744 0, 86.24320983886724 23.942594528198242 0, 86.23914337158203 23.943840026855526 0, 86.22010803222662 23.946704864501896 0, 86.21056365966803 23.94543647766119 0, 86.2028274536134 23.948303222656364 0, 86.19558715820324 23.94889831542963 0, 86.18388366699224 23.94561576843256 0, 86.17847442626953 23.945552825927678 0, 86.17046356201172 23.94317245483404 0, 86.16279602050776 23.93852424621582 0, 86.15834808349615 23.938175201416016 0, 86.149658203125 23.93540000915533 0, 86.13497161865234 23.937004089355526 0, 86.1320190429688 23.931713104248104 0, 86.12757873535156 23.91937637329113 0, 86.12923431396479 23.913105010986442 0, 86.12622833251953 23.910902023315373 0, 86.1249618530274 23.90290260314947 0, 86.12158203125011 23.89783477783203 0, 86.11814880371105 23.896011352539176 0, 86.11687469482422 23.894491195678654 0, 86.1110229492188 23.893150329589957 0, 86.11013031005871 23.891250610351676 0, 86.092514038086 23.88973999023449 0, 86.0690536499024 23.895952224731445 0, 86.0602645874024 23.8988552093507 0, 86.05442047119152 23.90240478515625 0, 86.04918670654297 23.90408515930187 0, 86.04097747802734 23.902290344238338 0, 86.0336380004884 23.899629592895565 0, 86.02980804443371 23.899227142333984 0, 86.02645874023438 23.90046501159668 0, 86.02443695068365 23.902296066284293 0, 86.0229110717774 23.90604209899908 0, 86.01987457275396 23.909849166870174 0, 86.01576232910156 23.911853790283203 0, 86.0076293945313 23.91161918640148 0, 86.00375366210938 23.91020584106451 0, 85.99925994873053 23.908445358276367 0, 85.99645996093761 23.906925201416072 0, 85.98609924316412 23.902519226074332 0, 85.981216430664 23.900588989257926 0, 85.97525787353527 23.898784637451286 0, 85.96631622314464 23.898303985595703 0, 85.95774078369152 23.899284362793082 0, 85.95500946044928 23.901048660278434 0, 85.95161437988293 23.90781593322754 0, 85.95068359375011 23.911630630493164 0, 85.95020294189459 23.919490814208984 0, 85.94982910156256 23.925672531127987 0, 85.9480361938476 23.930259704589844 0, 85.94486236572271 23.933238983154354 0, 85.94305419921886 23.933216094970703 0, 85.9406509399414 23.93100547790533 0, 85.93863677978527 23.930030822753906 0, 85.93244171142578 23.926992416381893 0, 85.92890930175793 23.926485061645508 0, 85.92782592773438 23.92901420593256 0, 85.92913818359386 23.93578338623047 0, 85.92866516113287 23.943082809448356 0, 85.92650604248047 23.94841957092285 0, 85.92324829101562 23.95177078247076 0, 85.91757202148438 23.954755783080998 0, 85.91747283935558 23.956342697143555 0, 85.92114257812494 23.956737518310604 0, 85.9273300170899 23.955888748169002 0, 85.9315872192384 23.963111877441463 0, 85.93216705322277 23.969911575317496 0, 85.92479705810547 23.978872299194393 0, 85.9198226928711 23.97825241088873 0, 85.91835784912115 23.981533050537166 0, 85.91365051269543 23.982030868530217 0, 85.91151428222662 23.985170364379996 0, 85.90403747558594 23.988134384155217 0, 85.89997863769531 23.988513946533203 0, 85.8962860107423 23.992134094238338 0, 85.89427947998047 24.00394058227539 0, 85.89329528808588 24.01267051696783 0, 85.8892211914063 24.017360687255916 0, 85.884994506836 24.01979064941412 0, 85.88121795654308 24.020788192749023 0, 85.88213348388678 24.026401519775504 0, 85.88960266113287 24.032173156738338 0, 85.88941955566418 24.03453445434576 0, 85.8791122436524 24.03486061096197 0, 85.876953125 24.038894653320426 0, 85.87471008300787 24.03834342956543 0, 85.87206268310558 24.038953781127987 0, 85.87062072753906 24.04275703430187 0, 85.87126922607428 24.04649925231928 0, 85.86821746826178 24.050481796264762 0, 85.86618804931652 24.049631118774528 0, 85.8636322021485 24.051168441772518 0, 85.86566162109375 24.05449867248541 0, 85.86351013183605 24.05665397644043 0, 85.85863494873047 24.054031372070312 0, 85.85518646240234 24.05368614196783 0, 85.84826660156261 24.056612014770565 0, 85.8480072021485 24.059429168701115 0, 85.8443374633789 24.06129074096691 0, 85.84270477294933 24.063180923462028 0, 85.84570312500006 24.067169189453125 0, 85.84313201904291 24.069065093994197 0, 85.83850097656261 24.06615257263178 0, 85.836669921875 24.066289901733512 0, 85.83271789550787 24.068082809448242 0, 85.83207702636719 24.071405410766545 0, 85.82853698730474 24.07428359985363 0, 85.8227005004884 24.077545166015682 0, 85.81821441650396 24.078807830810604 0, 85.81587219238281 24.077779769897404 0, 85.80770874023438 24.07065773010254 0, 85.80344390869152 24.07063484191889 0, 85.79560852050793 24.072378158569393 0, 85.79322052001953 24.074132919311637 0, 85.79740142822266 24.08286094665533 0, 85.79040527343756 24.084819793701172 0, 85.777816772461 24.08985710144043 0, 85.76553344726562 24.09650611877447 0, 85.77071380615234 24.106943130493164 0, 85.76338958740246 24.10906791687006 0, 85.7591400146485 24.105440139770565 0, 85.75491333007818 24.10366630554205 0, 85.74543762207043 24.105941772460938 0, 85.73850250244146 24.10572433471691 0, 85.73367309570312 24.10293197631836 0, 85.73087310791021 24.10032653808605 0, 85.72820281982428 24.100612640380973 0, 85.7281723022461 24.100639343261776 0, 85.72449493408197 24.1034774780274 0, 85.71582031250006 24.10366058349615 0, 85.71285247802729 24.105268478393555 0, 85.70567321777344 24.1056365966798 0, 85.70766448974621 24.11504745483404 0, 85.70741271972662 24.119779586791992 0, 85.71019744873047 24.124410629272518 0, 85.70554351806646 24.130611419677734 0, 85.69941711425787 24.135843276977653 0, 85.68630218505871 24.14566421508789 0, 85.67640686035168 24.149612426757812 0, 85.66761779785168 24.15661239624029 0, 85.6709823608399 24.161836624145508 0, 85.67245483398438 24.16789054870611 0, 85.67313385009777 24.174009323120174 0, 85.67643737792969 24.18335342407238 0, 85.70977020263683 24.193586349487305 0, 85.7233123779298 24.196435928344783 0, 85.72794342041016 24.198719024658203 0, 85.72959899902355 24.203052520751896 0, 85.72948455810547 24.20664787292486 0, 85.736572265625 24.206586837768555 0, 85.74038696289062 24.208124160766715 0, 85.74622344970714 24.20841407775879 0, 85.75527954101568 24.211175918579215 0, 85.76232910156256 24.21754455566412 0, 85.77017974853521 24.21440505981451 0, 85.7808685302735 24.217088699340934 0, 85.79077911376959 24.221450805664006 0, 85.79591369628912 24.230672836303768 0, 85.79846954345714 24.232563018798942 0, 85.8048095703125 24.226997375488224 0, 85.80884552001953 24.224521636962947 0, 85.81542968750011 24.21808624267578 0, 85.81724548339844 24.22032546997076 0, 85.8255767822265 24.22406959533697 0, 85.83318328857433 24.223354339599666 0, 85.84189605712896 24.224426269531307 0, 85.84394836425781 24.2234725952149 0, 85.84774780273438 24.219324111938533 0, 85.85129547119152 24.21789932250988 0, 85.85468292236334 24.21977615356451 0, 85.85033416748058 24.224740982055607 0, 85.8509750366211 24.230295181274414 0, 85.85305786132812 24.235836029052848 0, 85.85327911376953 24.24221420288086 0, 85.84817504882818 24.255300521850643 0, 85.84652709960949 24.25810623168951 0, 85.84259033203125 24.259244918823242 0, 85.83704376220703 24.25906944274908 0, 85.83234405517584 24.26004600524908 0, 85.8309326171875 24.26434516906744 0, 85.84875488281256 24.277900695800895 0, 85.85443115234375 24.283588409423828 0, 85.85521697998053 24.287630081176815 0, 85.85791778564459 24.29264640808111 0, 85.8676147460938 24.295278549194336 0, 85.8675537109375 24.300437927246094 0, 85.86911010742188 24.30557441711437 0, 85.86612701416021 24.312860488891545 0, 85.86680603027344 24.317836761474723 0, 85.86443328857433 24.319139480590934 0, 85.86411285400385 24.321865081787223 0, 85.86551666259771 24.32550430297846 0, 85.86563110351557 24.330375671386662 0, 85.86391448974604 24.335382461547795 0, 85.86125183105463 24.334768295288086 0, 85.8576126098634 24.335733413696403 0, 85.8526840209961 24.33538055419922 0, 85.8490371704101 24.33594131469738 0, 85.84796142578125 24.34129142761236 0, 85.84236145019526 24.3477783203125 0, 85.84241485595703 24.353174209594727 0, 85.84510803222662 24.358015060424805 0, 85.84606933593756 24.3617782592774 0, 85.85018920898432 24.368232727050838 0, 85.84795379638672 24.37336349487316 0, 85.84900665283214 24.3782196044923 0, 85.84542083740229 24.381799697876033 0, 85.84847259521479 24.391679763793945 0, 85.84779357910162 24.39557456970215 0, 85.84993743896496 24.401470184326172 0, 85.8470306396485 24.40764999389654 0, 85.84674072265636 24.411479949951286 0, 85.8506469726563 24.420557022094783 0, 85.83901214599615 24.4283905029298 0, 85.83551025390625 24.429988861084098 0, 85.83391571044933 24.43221092224121 0, 85.82948303222662 24.446994781494084 0, 85.82980346679688 24.45030212402355 0, 85.83679962158214 24.455966949462834 0, 85.84130096435553 24.460212707519645 0, 85.84635162353527 24.463586807250977 0, 85.84870910644531 24.46727561950678 0, 85.8511962890625 24.469221115112305 0, 85.86047363281261 24.490303039550838 0, 85.86446380615246 24.503547668456974 0, 85.86174774169928 24.513442993164176 0, 85.86563110351557 24.527328491210994 0, 85.8642959594726 24.530244827270565 0, 85.85123443603521 24.54006767272955 0, 85.83792877197277 24.547868728637695 0, 85.83386230468756 24.549480438232422 0, 85.82347106933605 24.550918579101562 0, 85.8148880004884 24.55106735229498 0, 85.80997467041016 24.55181503295904 0, 85.80766296386719 24.55305099487299 0, 85.80593109130854 24.558067321777457 0, 85.80248260498058 24.55920219421381 0, 85.80455017089855 24.565212249755973 0, 85.80350494384766 24.56957626342779 0, 85.80458068847668 24.57670402526867 0, 85.79966735839844 24.580640792846737 0, 85.79230499267584 24.592500686645508 0, 85.79230499267584 24.599231719970703 0, 85.79442596435553 24.604143142700195 0, 85.79920196533214 24.609256744384822 0, 85.80135345458979 24.613182067871207 0, 85.78780364990246 24.608091354370117 0, 85.7840347290039 24.609180450439453 0, 85.77490234375 24.613565444946346 0, 85.76921844482428 24.614257812500057 0, 85.76535034179688 24.61679458618164 0, 85.76249694824219 24.62645149230957 0, 85.76414489746105 24.629863739013786 0, 85.77284240722662 24.639413833618107 0, 85.77774047851562 24.647720336914176 0, 85.7830047607423 24.652133941650447 0, 85.78396606445324 24.65960693359375 0, 85.78794097900396 24.665781021118164 0, 85.79326629638678 24.670310974121094 0, 85.79882812500011 24.673671722412166 0, 85.80762481689464 24.674394607544002 0, 85.82576751708979 24.667940139770565 0, 85.83182525634777 24.670194625854606 0, 85.83879089355469 24.670932769775334 0, 85.83984375000011 24.673191070556754 0, 85.8350448608399 24.680374145507756 0, 85.8348236083985 24.685251235961914 0, 85.83161163330084 24.686159133911133 0, 85.83068084716808 24.693422317504883 0, 85.82761383056646 24.698793411254883 0, 85.8267059326173 24.7067546844483 0, 85.82483673095703 24.711931228637695 0, 85.8187866210938 24.71641159057623 0, 85.81764221191412 24.722867965698242 0, 85.82012176513678 24.730209350585938 0, 85.82799530029303 24.73552322387701 0, 85.83658599853527 24.737871170043945 0, 85.84541320800776 24.739280700683707 0, 85.85266876220697 24.738628387451115 0, 85.85568237304699 24.742946624755916 0, 85.86034393310547 24.74214744567871 0, 85.86314392089855 24.738920211791992 0, 85.8746566772461 24.74048995971691 0, 85.88256835937511 24.738965988159237 0, 85.8912124633789 24.736268997192496 0, 85.892807006836 24.73927879333496 0, 85.89288330078136 24.741958618164176 0, 85.88758087158203 24.748628616333065 0, 85.8885498046875 24.75449943542492 0, 85.89530181884771 24.755073547363338 0, 85.89827728271484 24.754409790039062 0, 85.8996353149414 24.755794525146428 0, 85.89934539794933 24.756843566894474 0, 85.9091567993164 24.76202011108404 0))",both
DEOGHAR,1491879,776741,715138,602,"POLYGON Z ((86.6131820678711 24.608688354492188 0, 86.61357116699219 24.603801727294922 0, 86.61325073242193 24.603202819824276 0, 86.61179351806635 24.60059547424322 0, 86.6107864379884 24.59564018249506 0, 86.62271881103516 24.595993041992244 0, 86.62213897705078 24.58578681945812 0, 86.63100433349621 24.580932617187557 0, 86.6380462646485 24.578001022338924 0, 86.64511108398449 24.577438354492188 0, 86.64957427978516 24.56855201721197 0, 86.65975952148443 24.564542770385685 0, 86.67220306396496 24.561992645263786 0, 86.68147277832031 24.567459106445256 0, 86.68531036376959 24.566419601440543 0, 86.69042205810547 24.571773529052734 0, 86.69914245605463 24.570262908935547 0, 86.71367645263672 24.574893951416072 0, 86.72238159179699 24.579557418823356 0, 86.73532867431652 24.57716178894043 0, 86.73883056640625 24.582193374633732 0, 86.74325561523438 24.58784294128418 0, 86.74939727783209 24.59085845947277 0, 86.7483520507812 24.604209899902457 0, 86.75461578369152 24.61930084228527 0, 86.757797241211 24.616079330444336 0, 86.77285766601568 24.617807388305778 0, 86.77923583984386 24.61689949035639 0, 86.77892303466797 24.620832443237305 0, 86.78085327148443 24.62108612060547 0, 86.78456878662121 24.616180419921932 0, 86.78779602050793 24.61161994934082 0, 86.7901840209961 24.60592651367199 0, 86.79059600830084 24.600728988647575 0, 86.79808044433605 24.598184585571403 0, 86.79801177978516 24.60205459594738 0, 86.79622650146479 24.606523513794002 0, 86.79403686523443 24.609796524047965 0, 86.79109191894531 24.612266540527287 0, 86.7895736694336 24.614431381225643 0, 86.78932952880871 24.61852836608881 0, 86.79557037353521 24.61664009094244 0, 86.79807281494146 24.613430023193416 0, 86.80031585693365 24.60986709594738 0, 86.80120086669922 24.60708618164074 0, 86.8017807006836 24.604820251464957 0, 86.8023681640625 24.602499008178654 0, 86.80388641357422 24.599937438964844 0, 86.80547332763678 24.598817825317383 0, 86.80947113037115 24.59586715698248 0, 86.8081665039063 24.59201812744152 0, 86.80857086181652 24.58675575256342 0, 86.80993652343761 24.582523345947322 0, 86.811294555664 24.578231811523494 0, 86.80690002441418 24.575761795043945 0, 86.80487823486328 24.573364257812443 0, 86.8040237426759 24.570093154907283 0, 86.80385589599604 24.567327499389705 0, 86.80395507812506 24.565998077392692 0, 86.80866241455078 24.565519332885742 0, 86.81239318847668 24.565172195434684 0, 86.8172378540039 24.569599151611442 0, 86.82191467285162 24.570741653442326 0, 86.82512664794928 24.569719314575252 0, 86.8292465209961 24.567407608032283 0, 86.83517456054688 24.569459915161133 0, 86.84070587158203 24.569683074951172 0, 86.84222412109375 24.56418991088873 0, 86.8423309326173 24.56004142761236 0, 86.84244537353516 24.555498123168945 0, 86.85073852539074 24.554388046264762 0, 86.85824584960938 24.55189514160162 0, 86.86107635498041 24.558032989501953 0, 86.86522674560558 24.561695098876953 0, 86.87310028076166 24.562812805175838 0, 86.8768157958985 24.566408157348633 0, 86.88001251220703 24.568746566772404 0, 86.88270568847662 24.564477920532227 0, 86.88758087158214 24.561788558960018 0, 86.88774871826183 24.555917739868164 0, 86.89031982421875 24.555475234985295 0, 86.89669036865246 24.55628585815424 0, 86.90198516845709 24.551206588745117 0, 86.90476226806635 24.545949935913143 0, 86.90939331054688 24.542430877685547 0, 86.91474151611328 24.540142059326172 0, 86.91084289550793 24.533172607421875 0, 86.91077423095709 24.527204513549805 0, 86.90962219238287 24.522129058838004 0, 86.91149139404297 24.513032913208065 0, 86.91220092773432 24.506267547607536 0, 86.91141510009777 24.500534057617188 0, 86.9110488891601 24.495311737060547 0, 86.90937805175781 24.490030288696403 0, 86.90677642822271 24.48596763610834 0, 86.9043655395509 24.48273658752447 0, 86.90099334716797 24.475917816162166 0, 86.89701843261724 24.467531204223746 0, 86.89118957519543 24.4598770141601 0, 86.88744354248047 24.455093383789176 0, 86.88460540771484 24.44753837585455 0, 86.88337707519543 24.44053840637207 0, 86.88278198242199 24.433942794799805 0, 86.88307189941406 24.428533554077262 0, 86.89127349853516 24.432329177856445 0, 86.89553833007818 24.42641448974615 0, 86.8911590576173 24.424583435058537 0, 86.89531707763678 24.420389175415153 0, 86.89827728271479 24.414564132690487 0, 86.901596069336 24.411767959594783 0, 86.90752410888678 24.412719726562614 0, 86.91188812255865 24.40952301025385 0, 86.91854095458984 24.413511276245117 0, 86.92180633544928 24.41971778869629 0, 86.92998504638672 24.41784477233898 0, 86.93370819091808 24.42174148559576 0, 86.93939971923834 24.419963836669922 0, 86.93695068359386 24.40890502929699 0, 86.93411254882824 24.40184593200678 0, 86.92961883544922 24.396516799926815 0, 86.92280578613287 24.393722534179688 0, 86.9223022460937 24.388635635375977 0, 86.92322540283214 24.383703231811637 0, 86.92976379394531 24.37949562072754 0, 86.92755889892584 24.373737335205192 0, 86.93479156494146 24.35996055603033 0, 86.9509887695313 24.359245300293026 0, 86.96120452880871 24.355350494384822 0, 86.96216583251947 24.348936080932674 0, 86.9623794555664 24.342121124267578 0, 86.9603881835938 24.333616256713867 0, 86.95999145507818 24.32658195495611 0, 86.9598007202149 24.321935653686467 0, 86.96006011962902 24.317699432373047 0, 86.96602630615234 24.31230926513672 0, 86.97712707519537 24.31112098693859 0, 86.98562622070307 24.307003021240178 0, 86.99437713623058 24.312402725219783 0, 86.99616241455078 24.312732696533146 0, 86.99755859375006 24.312246322631836 0, 87.02305603027344 24.326404571533317 0, 87.03041076660168 24.317918777465877 0, 87.0337982177735 24.310768127441406 0, 87.03298950195312 24.304168701171932 0, 87.03210449218756 24.298290252685547 0, 87.03233337402355 24.29109001159668 0, 87.03202056884766 24.281433105468807 0, 87.03473663330084 24.272390365600586 0, 87.03807830810541 24.266614913940373 0, 87.04248809814453 24.262681961059684 0, 87.0489730834961 24.26012992858881 0, 87.0562515258789 24.25789833068859 0, 87.06307983398438 24.255704879760856 0, 87.06881713867188 24.253515243530273 0, 87.06764984130854 24.248327255249023 0, 87.06466674804693 24.24581909179699 0, 87.06135559082026 24.24294281005865 0, 87.05747222900396 24.23937606811529 0, 87.05563354492182 24.23392677307129 0, 87.05417633056646 24.228679656982422 0, 87.05113983154303 24.225543975830192 0, 87.04772186279303 24.220100402832145 0, 87.0504760742187 24.214941024780273 0, 87.05026245117199 24.2128963470459 0, 87.05038452148443 24.209619522094783 0, 87.05295562744135 24.204910278320312 0, 87.048080444336 24.200160980224723 0, 87.04420471191406 24.195837020874137 0, 87.0404891967774 24.199487686157283 0, 87.035140991211 24.202667236328182 0, 87.03124237060547 24.202527999877873 0, 87.02527618408214 24.203985214233455 0, 87.02314758300793 24.20630264282221 0, 87.019271850586 24.209957122802734 0, 87.01572418212902 24.20919799804699 0, 87.00064086914074 24.215036392211914 0, 86.99198913574219 24.218044281005916 0, 86.98591613769537 24.218986511230412 0, 86.97708129882812 24.220462799072266 0, 86.97205352783214 24.217702865600643 0, 86.97030639648443 24.213809967041072 0, 86.97241210937511 24.208507537841854 0, 86.97566986083996 24.202117919921932 0, 86.97417449951183 24.192880630493278 0, 86.97512817382824 24.186906814575252 0, 86.96132659912115 24.184347152710018 0, 86.95608520507812 24.178813934326286 0, 86.95066070556646 24.17001533508295 0, 86.94749450683594 24.169113159179744 0, 86.93920135498053 24.17112350463873 0, 86.93682861328125 24.164619445800724 0, 86.93549346923828 24.16045379638672 0, 86.93366241455084 24.151870727539062 0, 86.93177795410162 24.14430999755865 0, 86.93215179443365 24.139165878296012 0, 86.9420776367188 24.137678146362248 0, 86.95198059082037 24.132566452026367 0, 86.96001434326183 24.129404067993164 0, 86.96009063720703 24.12272453308111 0, 86.96166992187506 24.115871429443473 0, 86.96548461914068 24.114503860473576 0, 86.97162628173834 24.111902236938477 0, 86.97714233398443 24.1099529266358 0, 86.97710418701172 24.109899520874023 0, 86.97020721435547 24.100255966186637 0, 86.97335815429693 24.08920669555664 0, 86.97421264648438 24.080831527709904 0, 86.9706039428711 24.074583053588867 0, 86.97075653076166 24.06310462951666 0, 86.96144104003906 24.061943054199276 0, 86.95405578613287 24.05629539489746 0, 86.95704650878906 24.05053901672369 0, 86.94924926757812 24.04593658447277 0, 86.94114685058605 24.045110702514705 0, 86.9283294677735 24.04838752746582 0, 86.91609191894537 24.054372787475586 0, 86.91077423095709 24.06023979187006 0, 86.91560363769543 24.065170288085994 0, 86.91025543212902 24.067321777343864 0, 86.89934539794928 24.065265655517635 0, 86.88938140869146 24.07123184204113 0, 86.8796157836914 24.075357437133903 0, 86.87657928466797 24.073316574096737 0, 86.87548065185553 24.069564819335994 0, 86.8711395263673 24.067361831665153 0, 86.86531829833984 24.069057464599666 0, 86.85977935791016 24.066341400146484 0, 86.84458160400396 24.062500000000057 0, 86.84139251708996 24.056787490844783 0, 86.83094024658197 24.057006835937614 0, 86.82048034667969 24.078174591064453 0, 86.81124877929699 24.07861328125 0, 86.80815124511724 24.080783843994084 0, 86.80742645263683 24.088619232177678 0, 86.8060073852539 24.089622497558707 0, 86.80190277099621 24.084730148315487 0, 86.79563903808605 24.088895797729492 0, 86.79154205322271 24.084472656250114 0, 86.78579711914062 24.08330726623541 0, 86.7858505249024 24.07228660583496 0, 86.78040313720697 24.070476531982536 0, 86.77239227294916 24.07304763793951 0, 86.76565551757824 24.072002410888786 0, 86.7631225585938 24.078281402588004 0, 86.7568817138673 24.082862854003906 0, 86.75369262695307 24.086425781249943 0, 86.75961303710932 24.091878890991325 0, 86.75478363037121 24.098653793335018 0, 86.74974060058594 24.0989284515382 0, 86.74154663085938 24.100038528442383 0, 86.72798156738281 24.104503631591797 0, 86.71603393554693 24.108261108398494 0, 86.7102890014649 24.111265182495174 0, 86.70326232910162 24.110855102539062 0, 86.69843292236328 24.111766815185604 0, 86.69303894042963 24.117267608642578 0, 86.69030761718756 24.12257385253912 0, 86.69100189208984 24.1339950561524 0, 86.69310760498047 24.142913818359375 0, 86.69622039794928 24.144329071044922 0, 86.70219421386713 24.14497566223156 0, 86.70787811279308 24.14776802062994 0, 86.70649719238287 24.156129837036133 0, 86.70439910888678 24.162523269653434 0, 86.6998977661134 24.16477203369152 0, 86.69754791259771 24.16647338867199 0, 86.69255065917974 24.169471740722713 0, 86.6881713867188 24.166797637939567 0, 86.6866302490235 24.162403106689567 0, 86.683822631836 24.15674018859869 0, 86.68297576904297 24.152343750000057 0, 86.68265533447271 24.146945953369254 0, 86.68019104003912 24.143667221069393 0, 86.67790985107428 24.13950920104986 0, 86.67475891113281 24.13639831542963 0, 86.67188262939453 24.13503074645996 0, 86.66616821289062 24.134965896606445 0, 86.66244506835943 24.13429450988781 0, 86.65523529052746 24.13407135009777 0, 86.64978790283203 24.13492774963379 0, 86.643539428711 24.136608123779354 0, 86.63282012939453 24.137973785400504 0, 86.62320709228527 24.13822746276867 0, 86.62011718750006 24.139360427856445 0, 86.61648559570318 24.141368865966854 0, 86.6109237670899 24.143331527710018 0, 86.6075057983399 24.14254951477045 0, 86.60310363769537 24.14235877990717 0, 86.59746551513683 24.14380073547369 0, 86.59313201904297 24.144361495971623 0, 86.58989715576172 24.14392471313471 0, 86.58658599853527 24.14098358154297 0, 86.58187103271484 24.141723632812443 0, 86.57847595214844 24.142738342285156 0, 86.57444763183594 24.14280128479004 0, 86.57339477539074 24.140657424926758 0, 86.56362152099615 24.1481990814209 0, 86.55245208740246 24.15457725524908 0, 86.54653167724621 24.151416778564453 0, 86.54098510742199 24.1527042388916 0, 86.52957153320324 24.15532684326172 0, 86.5255737304687 24.156826019287166 0, 86.52306365966808 24.15367698669445 0, 86.51829528808605 24.1498641967774 0, 86.51309204101568 24.14820289611822 0, 86.50683593750011 24.148220062255916 0, 86.50185394287115 24.14989662170416 0, 86.49599456787121 24.15112686157238 0, 86.48697662353521 24.15256118774414 0, 86.49374389648438 24.163455963134822 0, 86.49810028076183 24.175348281860295 0, 86.50303649902355 24.1837158203125 0, 86.50371551513678 24.192089080810604 0, 86.5023193359375 24.199031829834098 0, 86.505844116211 24.202917098998967 0, 86.50978088378906 24.206853866577205 0, 86.51090240478516 24.21619033813488 0, 86.51551818847656 24.22340583801264 0, 86.51114654541016 24.22987174987793 0, 86.50997924804688 24.23456764221197 0, 86.51467132568371 24.238603591919002 0, 86.51318359374994 24.243530273437614 0, 86.51078796386724 24.249044418335075 0, 86.51129150390625 24.25914573669445 0, 86.51049804687511 24.264354705810604 0, 86.50833892822271 24.269983291625977 0, 86.50724029541027 24.275598526001033 0, 86.5046157836914 24.28267478942871 0, 86.49923706054699 24.283718109130973 0, 86.4932479858399 24.284658432006893 0, 86.48850250244146 24.28691482543951 0, 86.4862518310548 24.289827346801758 0, 86.48473358154308 24.296550750732422 0, 86.47949218750006 24.298112869262752 0, 86.47662353515625 24.302131652831974 0, 86.47608184814459 24.30692672729498 0, 86.47457885742193 24.310932159423885 0, 86.47196197509777 24.31390953063959 0, 86.47267150878912 24.32112121582037 0, 86.47307586669933 24.328386306762695 0, 86.47013092041016 24.330444335937557 0, 86.46723937988281 24.33203697204584 0, 86.46136474609375 24.33337974548334 0, 86.46037292480469 24.337839126587028 0, 86.4629592895509 24.341394424438533 0, 86.46485137939459 24.343852996826172 0, 86.46724700927734 24.347579956054688 0, 86.46793365478527 24.351724624633903 0, 86.46720123291027 24.353061676025447 0, 86.46127319335949 24.354633331298942 0, 86.45751190185547 24.35630035400385 0, 86.45645141601568 24.36052322387701 0, 86.4574432373048 24.365245819091797 0, 86.45644378662115 24.36881446838379 0, 86.45608520507818 24.370113372802848 0, 86.45893096923834 24.375448226928768 0, 86.46566772460949 24.37820053100586 0, 86.46955108642578 24.38647079467779 0, 86.4709930419923 24.396615982055664 0, 86.46755981445324 24.409189224243107 0, 86.46956634521484 24.415229797363395 0, 86.4675750732423 24.419929504394588 0, 86.4697265625 24.423313140869254 0, 86.47730255126964 24.424198150634822 0, 86.48595428466797 24.426404953003043 0, 86.49246215820318 24.42643547058117 0, 86.49208068847662 24.435281753540153 0, 86.49581909179682 24.440719604492244 0, 86.49486541748041 24.44835472106945 0, 86.49502563476574 24.45545387268072 0, 86.48838806152338 24.460216522216797 0, 86.49365234375006 24.46898841857916 0, 86.49268341064459 24.47564125061041 0, 86.4947280883789 24.480121612548885 0, 86.49417877197271 24.485731124878043 0, 86.49922180175793 24.486650466918945 0, 86.50202941894537 24.48863220214855 0, 86.50143432617193 24.499324798583984 0, 86.50965118408209 24.519029617309684 0, 86.52744293212902 24.537059783935547 0, 86.53435516357416 24.534255981445256 0, 86.54004669189464 24.537765502929688 0, 86.54446411132807 24.537948608398438 0, 86.55058288574219 24.53636550903326 0, 86.55522918701178 24.544742584228572 0, 86.56181335449213 24.549797058105526 0, 86.55854797363293 24.56057929992687 0, 86.56221771240234 24.560590744018555 0, 86.56561279296886 24.56441307067871 0, 86.57193756103516 24.56410598754877 0, 86.58213043212896 24.56917381286621 0, 86.5870361328125 24.574077606201172 0, 86.58777618408203 24.586601257324276 0, 86.59365081787121 24.59397125244135 0, 86.59874725341803 24.598350524902287 0, 86.6038665771485 24.60076713562023 0, 86.60681152343761 24.606334686279297 0, 86.6131820678711 24.608688354492188 0))",both
GODDA,1311382,678504,632878,622,"POLYGON Z ((87.42015838623047 25.215839385986442 0, 87.45861816406261 25.19845008850092 0, 87.46134185791016 25.198749542236328 0, 87.46543121337896 25.196109771728572 0, 87.47035217285156 25.19660949707037 0, 87.4711303710938 25.19410324096674 0, 87.47564697265625 25.19562911987299 0, 87.48100280761719 25.17547798156744 0, 87.492431640625 25.153333663940373 0, 87.49781799316406 25.137647628784293 0, 87.47396087646484 25.106491088867188 0, 87.47731018066418 25.10124397277832 0, 87.48429870605474 25.098892211914062 0, 87.48993682861322 25.094409942626953 0, 87.49276733398449 25.086074829101562 0, 87.49633789062506 25.083110809326115 0, 87.50027465820312 25.075767517089787 0, 87.50965118408209 25.06619262695324 0, 87.517318725586 25.06237220764166 0, 87.52058410644543 25.058221817016715 0, 87.51673126220709 25.057796478271484 0, 87.51207733154297 25.054931640625114 0, 87.50751495361328 25.05528831481945 0, 87.50711822509766 25.05633544921875 0, 87.50431060791021 25.052537918090763 0, 87.50855255126959 25.040630340576172 0, 87.50321197509771 25.027896881103572 0, 87.49566650390625 25.019266128540096 0, 87.4896926879884 25.016050338745117 0, 87.4864120483399 25.01555061340332 0, 87.48029327392584 25.012166976928825 0, 87.47255706787121 25.001300811767578 0, 87.47140502929699 25.000000000000114 0, 87.46627044677746 24.994209289550838 0, 87.46451568603527 24.99030113220215 0, 87.46631622314453 24.987503051757812 0, 87.47052001953125 24.98563957214367 0, 87.47476196289068 24.98291015625 0, 87.47561645507824 24.978319168090934 0, 87.4754638671875 24.972761154174805 0, 87.4750213623048 24.968076705932674 0, 87.47264099121094 24.96845626831066 0, 87.47111511230469 24.961996078491325 0, 87.4695816040039 24.954618453979492 0, 87.4634780883789 24.953212738037053 0, 87.46399688720697 24.947877883911133 0, 87.46008300781256 24.94320869445812 0, 87.45994567871105 24.937887191772518 0, 87.45664215087896 24.93332481384283 0, 87.45684051513678 24.92852783203125 0, 87.45671844482433 24.923740386962947 0, 87.45752716064453 24.917375564575195 0, 87.46226501464855 24.918045043945312 0, 87.46740722656261 24.917217254638672 0, 87.4668960571289 24.91208648681652 0, 87.46635437011724 24.90771102905279 0, 87.46469879150402 24.903236389160213 0, 87.46166229248058 24.899068832397575 0, 87.4579086303711 24.896650314331055 0, 87.45246887207037 24.894430160522518 0, 87.45414733886724 24.888980865478516 0, 87.4571762084961 24.884893417358455 0, 87.46184539794933 24.88066482543951 0, 87.46562957763678 24.87701988220215 0, 87.46546173095714 24.873388290405273 0, 87.45688629150402 24.871103286743278 0, 87.45752716064453 24.861921310424805 0, 87.46308135986328 24.86304283142084 0, 87.46730804443365 24.858591079711914 0, 87.47236633300793 24.860761642455998 0, 87.475830078125 24.860813140869197 0, 87.47698974609375 24.858257293701172 0, 87.47245025634766 24.85711860656744 0, 87.47028350830072 24.854846954345703 0, 87.47462463378918 24.855125427246094 0, 87.47393798828125 24.85046195983881 0, 87.47730255126964 24.84734535217285 0, 87.47702026367188 24.844814300537166 0, 87.4759979248048 24.837793350219727 0, 87.47718811035156 24.831827163696403 0, 87.48109436035162 24.827781677246207 0, 87.48186492919933 24.823444366455135 0, 87.48444366455078 24.818321228027344 0, 87.48905944824224 24.81484031677246 0, 87.4925155639649 24.810056686401367 0, 87.49610137939453 24.805385589599553 0, 87.50191497802746 24.80176162719721 0, 87.5095672607423 24.798494338989258 0, 87.50852203369146 24.797815322876033 0, 87.499008178711 24.791627883911133 0, 87.494888305664 24.78915977478033 0, 87.49716949462902 24.786579132080078 0, 87.49385070800787 24.784385681152344 0, 87.49059295654303 24.784843444824332 0, 87.48735809326178 24.786054611206055 0, 87.4849319458009 24.78823089599615 0, 87.48324584960949 24.788772583007812 0, 87.48110198974621 24.78863716125494 0, 87.47840118408209 24.78845405578619 0, 87.47357940673828 24.789400100708065 0, 87.46775817871105 24.79058265686041 0, 87.4628372192384 24.79331779479986 0, 87.45937347412121 24.79303550720209 0, 87.45703125000006 24.78822708129877 0, 87.45415496826178 24.781520843505973 0, 87.45061492919933 24.77666854858404 0, 87.44618988037115 24.771436691284293 0, 87.44075775146484 24.765979766845703 0, 87.43627929687511 24.76178169250494 0, 87.43500518798822 24.7568416595459 0, 87.4354476928711 24.753141403198356 0, 87.4382553100586 24.751594543457088 0, 87.44214630126959 24.751300811767635 0, 87.44620513916027 24.74627494812023 0, 87.45137786865246 24.739955902099723 0, 87.45470428466797 24.735979080200195 0, 87.45735168457031 24.732881546020508 0, 87.45489501953125 24.728878021240348 0, 87.4547805786134 24.725942611694336 0, 87.46041870117188 24.72474670410162 0, 87.4619140625 24.720743179321346 0, 87.46277618408209 24.715707778930607 0, 87.46262359619152 24.710693359374943 0, 87.46337127685558 24.706178665161133 0, 87.46703338623058 24.69988441467285 0, 87.46881103515625 24.693630218505803 0, 87.47038269042974 24.686508178710938 0, 87.46707916259766 24.680673599243164 0, 87.46933746337885 24.673370361328125 0, 87.47037506103521 24.667694091796932 0, 87.47123718261713 24.659088134765682 0, 87.46985626220714 24.65183830261236 0, 87.4673461914063 24.64795684814453 0, 87.46387481689459 24.64345550537115 0, 87.45845794677729 24.63840484619135 0, 87.452621459961 24.63475036621105 0, 87.4488983154298 24.630311965942383 0, 87.446762084961 24.626131057739315 0, 87.44705963134766 24.621337890625057 0, 87.44782257080078 24.61843681335455 0, 87.45073699951178 24.61660003662115 0, 87.45928955078125 24.616748809814396 0, 87.46138763427734 24.610889434814453 0, 87.4638061523437 24.602483749389762 0, 87.45510101318365 24.596334457397518 0, 87.45503234863276 24.591489791870117 0, 87.45531463623053 24.586116790771484 0, 87.45928192138672 24.583230972290096 0, 87.46338653564464 24.581426620483455 0, 87.46704864501947 24.578598022460994 0, 87.46653747558594 24.574975967407227 0, 87.46369934082037 24.570228576660213 0, 87.46010589599615 24.56861686706543 0, 87.45619201660156 24.567354202270508 0, 87.45043182373058 24.564563751220703 0, 87.44470977783214 24.564020156860465 0, 87.43846893310547 24.56585121154785 0, 87.43643188476568 24.560056686401424 0, 87.43202972412115 24.55961227416998 0, 87.42572784423834 24.55803871154791 0, 87.42156219482428 24.55619430541998 0, 87.4199447631836 24.553220748901424 0, 87.41819000244152 24.549274444580078 0, 87.41481018066406 24.54632568359375 0, 87.40955352783209 24.546869277954215 0, 87.40726470947271 24.544830322265682 0, 87.40650177001959 24.540912628173828 0, 87.40607452392578 24.53740882873535 0, 87.4039306640625 24.537208557128963 0, 87.40293121337902 24.540973663330135 0, 87.4005355834961 24.544181823730412 0, 87.39750671386724 24.546886444091854 0, 87.39293670654303 24.547479629516545 0, 87.38958740234386 24.545921325683594 0, 87.39028167724615 24.5422744750976 0, 87.38991546630865 24.53546905517578 0, 87.38813018798828 24.52903556823742 0, 87.3874130249024 24.52396774291998 0, 87.38821411132824 24.51910781860346 0, 87.391586303711 24.514551162719783 0, 87.39542388916021 24.511264801025504 0, 87.40318298339844 24.506467819213924 0, 87.40234375000011 24.50212287902832 0, 87.39775848388683 24.501960754394588 0, 87.39242553710949 24.502395629882926 0, 87.38577270507824 24.502849578857536 0, 87.3787078857423 24.504692077636662 0, 87.37569427490234 24.508380889892692 0, 87.37535858154297 24.513818740844783 0, 87.3729934692384 24.51883125305187 0, 87.36993408203136 24.523323059082088 0, 87.36563873291016 24.52854156494135 0, 87.3610610961914 24.536016464233455 0, 87.35724639892578 24.5409317016601 0, 87.35442352294928 24.544384002685604 0, 87.35033416748047 24.547344207763672 0, 87.34677886962896 24.552425384521598 0, 87.3437957763673 24.557788848877067 0, 87.34047698974615 24.56154441833496 0, 87.33821105957037 24.561355590820256 0, 87.33425140380871 24.564477920532227 0, 87.33140563964855 24.56730461120611 0, 87.33007812500011 24.570619583129883 0, 87.33042144775402 24.57506752014166 0, 87.33020782470709 24.57783889770502 0, 87.32868194580084 24.57971572875988 0, 87.32594299316406 24.58161544799816 0, 87.32290649414062 24.583398818969727 0, 87.31823730468761 24.586368560791072 0, 87.31428527832031 24.589555740356502 0, 87.31327056884777 24.592807769775447 0, 87.31191253662115 24.5970458984375 0, 87.3073120117188 24.596374511718807 0, 87.3004837036134 24.597705841064453 0, 87.29518127441418 24.596183776855526 0, 87.28904724121105 24.59808158874523 0, 87.28537750244146 24.600334167480526 0, 87.28215026855474 24.602067947387695 0, 87.27872467041021 24.6035213470459 0, 87.2753143310548 24.60282707214367 0, 87.27186584472668 24.599765777588004 0, 87.2679443359375 24.59475135803234 0, 87.26272583007824 24.5915470123291 0, 87.25691223144531 24.590143203735465 0, 87.25160217285162 24.58861923217779 0, 87.24665832519537 24.58621788024908 0, 87.24147033691406 24.58787918090826 0, 87.23483276367193 24.58932876586914 0, 87.22995758056635 24.59074783325201 0, 87.22339630126959 24.59277534484869 0, 87.22097015380871 24.590562820434684 0, 87.21695709228527 24.588148117065543 0, 87.21251678466803 24.589330673217717 0, 87.20992279052746 24.592100143432674 0, 87.20743560791027 24.59359169006359 0, 87.20450592041021 24.594171524047965 0, 87.19914245605474 24.596996307373104 0, 87.19406127929699 24.601490020751896 0, 87.18954467773438 24.60511398315424 0, 87.18580627441412 24.607442855835075 0, 87.18000030517578 24.606569290161246 0, 87.17668914794933 24.60832023620611 0, 87.17324066162115 24.61203002929699 0, 87.1693954467774 24.615409851074276 0, 87.16358184814447 24.615116119384822 0, 87.15876770019543 24.61394309997553 0, 87.15372467041016 24.61438751220703 0, 87.14863586425787 24.616630554199332 0, 87.143295288086 24.619453430175838 0, 87.13790893554693 24.622968673706055 0, 87.13383483886713 24.62674331665039 0, 87.12965393066406 24.629011154174748 0, 87.12560272216808 24.628555297851562 0, 87.12116241455084 24.628564834594727 0, 87.11709594726562 24.6294841766358 0, 87.11003875732422 24.62979125976574 0, 87.10629272460943 24.630689620971793 0, 87.10028839111328 24.63267517089838 0, 87.0958099365235 24.635282516479606 0, 87.0899887084961 24.638231277465934 0, 87.0857925415039 24.63768768310547 0, 87.07981109619152 24.637414932251033 0, 87.07518768310553 24.639768600463924 0, 87.06861877441406 24.642564773559627 0, 87.06285095214855 24.642892837524414 0, 87.05850219726562 24.639738082885742 0, 87.05548095703125 24.63428878784191 0, 87.05335235595703 24.627302169799748 0, 87.0478744506836 24.62544822692871 0, 87.04929351806652 24.632310867309684 0, 87.05229949951178 24.63842010498047 0, 87.05388641357433 24.644836425781364 0, 87.05449676513672 24.650657653808594 0, 87.05587768554688 24.656894683837947 0, 87.05826568603527 24.662067413330135 0, 87.05882263183605 24.666461944580135 0, 87.0582122802735 24.671972274780273 0, 87.06243133544928 24.673620223999137 0, 87.06367492675781 24.67858314514166 0, 87.06482696533203 24.682884216308594 0, 87.06731414794922 24.686393737793026 0, 87.07052612304688 24.689825057983512 0, 87.07283020019531 24.69259834289562 0, 87.0741348266601 24.69584274291998 0, 87.07438659667969 24.70019149780279 0, 87.0748901367187 24.704469680786133 0, 87.07475280761719 24.70868301391596 0, 87.076156616211 24.71224021911621 0, 87.07719421386719 24.71384620666504 0, 87.08013153076178 24.71592140197754 0, 87.08123779296875 24.72011566162115 0, 87.0838088989259 24.72329139709484 0, 87.0853729248048 24.725854873657227 0, 87.08586120605474 24.728317260742244 0, 87.08490753173834 24.730567932128906 0, 87.08471679687506 24.73396492004406 0, 87.08484649658203 24.73723983764654 0, 87.08391571044922 24.738285064697266 0, 87.08201599121094 24.737453460693473 0, 87.08056640625011 24.736967086791935 0, 87.07913970947266 24.73773384094244 0, 87.07929229736328 24.739452362060547 0, 87.07988739013672 24.741226196289062 0, 87.07752227783214 24.741840362548942 0, 87.07711791992193 24.74436759948742 0, 87.07810211181652 24.746021270752067 0, 87.0800018310548 24.74678993225092 0, 87.0833511352539 24.74788475036621 0, 87.08514404296886 24.749631881713924 0, 87.08474731445318 24.75204849243164 0, 87.08451080322271 24.752977371215877 0, 87.08662414550787 24.754945755004996 0, 87.08860778808605 24.757099151611442 0, 87.08984375000006 24.759601593017692 0, 87.08839416503918 24.76278114318859 0, 87.08694458007812 24.76579666137701 0, 87.08607482910162 24.76925086975109 0, 87.08609771728527 24.774244308471737 0, 87.08639526367188 24.78049850463873 0, 87.0891571044923 24.78372192382824 0, 87.09158325195318 24.786497116088924 0, 87.09477996826172 24.789377212524414 0, 87.09642791748058 24.793540954589844 0, 87.09922027587896 24.798839569091854 0, 87.10023498535168 24.8027286529541 0, 87.10015106201178 24.805265426635742 0, 87.09751129150396 24.805646896362305 0, 87.09429168701183 24.803922653198185 0, 87.09243774414057 24.805328369140625 0, 87.08989715576178 24.807142257690543 0, 87.0870208740235 24.807819366455192 0, 87.08495330810558 24.80860519409191 0, 87.08435821533209 24.81073379516596 0, 87.0808944702149 24.809587478637695 0, 87.08071136474615 24.813037872314453 0, 87.08118438720697 24.815435409545955 0, 87.08088684082037 24.81935119628912 0, 87.08214569091791 24.823463439941406 0, 87.08393859863287 24.825571060180607 0, 87.0878143310548 24.824420928955192 0, 87.09132385253906 24.824249267578125 0, 87.09477996826172 24.824769973754996 0, 87.09853363037121 24.827409744262752 0, 87.10111999511724 24.831056594848746 0, 87.10326385498058 24.835969924926815 0, 87.10597991943354 24.840467453002987 0, 87.10820770263678 24.845670700073356 0, 87.10963439941406 24.84852600097662 0, 87.11308288574219 24.851978302001953 0, 87.11805725097656 24.856729507446346 0, 87.12273406982433 24.85516738891596 0, 87.12690734863293 24.854181289672795 0, 87.13087463378912 24.855670928955135 0, 87.13337707519537 24.858682632446346 0, 87.13629150390636 24.860769271850586 0, 87.14236450195324 24.860446929931697 0, 87.14807128906256 24.860412597656193 0, 87.15451049804693 24.8596248626709 0, 87.15522003173828 24.864273071289062 0, 87.15087890625006 24.863597869873047 0, 87.1514739990235 24.869060516357536 0, 87.1531829833985 24.87358093261713 0, 87.15807342529297 24.877647399902344 0, 87.16008758544928 24.881881713867244 0, 87.1616668701173 24.886800765991268 0, 87.16178894042974 24.890722274780273 0, 87.16052246093761 24.89724922180187 0, 87.15789794921875 24.90126228332531 0, 87.15380859375011 24.904317855835018 0, 87.15234375 24.906238555908317 0, 87.15132141113293 24.909311294555664 0, 87.15008544921875 24.91399574279791 0, 87.1512222290039 24.918931961059627 0, 87.15328979492182 24.922355651855582 0, 87.15628051757824 24.92507362365734 0, 87.15820312500011 24.927644729614258 0, 87.15891265869146 24.93281555175787 0, 87.15573120117199 24.937646865844783 0, 87.1521987915039 24.943227767944393 0, 87.15238952636719 24.95048141479498 0, 87.15438079833996 24.956851959228516 0, 87.15619659423828 24.964088439941463 0, 87.15554809570324 24.969694137573242 0, 87.15565490722662 24.97551155090332 0, 87.15662384033209 24.984203338623104 0, 87.1573257446289 24.992027282714787 0, 87.15087127685547 25.000000000000114 0, 87.15012359619146 25.000917434692383 0, 87.14964294433605 25.004608154296818 0, 87.14814758300781 25.00746726989746 0, 87.14754486083996 25.01182556152355 0, 87.14786529541021 25.018999099731445 0, 87.15044403076172 25.025335311889762 0, 87.15270996093744 25.0272674560548 0, 87.1559829711914 25.02754402160639 0, 87.16201019287121 25.032022476196346 0, 87.16864776611334 25.043830871582088 0, 87.16870880126964 25.046878814697266 0, 87.1719436645509 25.049757003784293 0, 87.17216491699213 25.049959182739315 0, 87.17693328857416 25.057481765747184 0, 87.17749786376964 25.05900192260748 0, 87.18032073974621 25.065013885498047 0, 87.18798828125011 25.068008422851562 0, 87.19142913818354 25.067995071411076 0, 87.20114135742199 25.074649810791072 0, 87.20352172851568 25.080429077148494 0, 87.21196746826178 25.084306716919002 0, 87.21437072753906 25.086233139038086 0, 87.21500396728521 25.090579986572266 0, 87.21929931640625 25.09117126464855 0, 87.22161865234375 25.08952713012701 0, 87.23074340820312 25.088556289672965 0, 87.2375106811524 25.086807250976676 0, 87.24350738525385 25.10043907165533 0, 87.24469757080078 25.101779937744254 0, 87.24895477294928 25.100061416625977 0, 87.25287628173828 25.106357574463004 0, 87.25421142578125 25.106826782226676 0, 87.26238250732416 25.105590820312557 0, 87.26669311523443 25.101806640625057 0, 87.26805877685558 25.098766326904297 0, 87.27384948730469 25.094635009765568 0, 87.27849578857428 25.09318733215332 0, 87.28918457031256 25.09192085266119 0, 87.29470062255865 25.090274810791072 0, 87.2989349365235 25.100696563720703 0, 87.29638671875 25.10568237304699 0, 87.2984619140625 25.11290931701666 0, 87.2984848022461 25.114803314208984 0, 87.29686737060558 25.115329742431584 0, 87.30152893066406 25.13562965393072 0, 87.30348205566412 25.13555335998535 0, 87.3070297241211 25.139097213745117 0, 87.30600738525402 25.14155387878418 0, 87.30706787109375 25.14416313171398 0, 87.30533599853516 25.144857406616268 0, 87.30590057373047 25.14627456665039 0, 87.31159210205072 25.151237487793082 0, 87.31324768066412 25.154504776001033 0, 87.31404113769543 25.161268234252987 0, 87.31798553466803 25.163700103759822 0, 87.31864929199213 25.165981292724666 0, 87.31800079345709 25.16830635070795 0, 87.316635131836 25.170196533203125 0, 87.31427764892578 25.17074775695812 0, 87.31964874267578 25.187225341796932 0, 87.32075500488276 25.18960189819336 0, 87.31937408447277 25.193904876709098 0, 87.31961822509766 25.19786453247076 0, 87.322006225586 25.202148437500057 0, 87.32712554931646 25.223978042602653 0, 87.33418273925787 25.223081588745174 0, 87.33409118652355 25.217964172363338 0, 87.35139465332037 25.2140789031983 0, 87.35871124267572 25.214313507080192 0, 87.36163330078125 25.212131500244197 0, 87.37206268310541 25.207815170288143 0, 87.3734970092774 25.205970764160213 0, 87.37754821777355 25.219453811645508 0, 87.38075256347662 25.223524093627873 0, 87.38689422607433 25.224378585815487 0, 87.3900756835938 25.226615905761832 0, 87.39537811279297 25.228420257568473 0, 87.40019989013678 25.226623535156193 0, 87.40573120117193 25.222322463989258 0, 87.41122436523438 25.219926834106502 0, 87.41306304931635 25.216060638427734 0, 87.42015838623047 25.215839385986442 0))",both
SAHIBGANJ,1150038,590390,559648,719,"POLYGON Z ((87.68417358398443 25.28359603881836 0, 87.71078491210949 25.267084121704215 0, 87.71017456054699 25.260738372802734 0, 87.71109008789068 25.257369995117188 0, 87.72434997558588 25.254404067993164 0, 87.73415374755865 25.25411415100109 0, 87.7660598754884 25.25026512145996 0, 87.77235412597668 25.247646331787166 0, 87.78652954101557 25.247171401977596 0, 87.7869033813476 25.243988037109318 0, 87.78841400146496 25.24145317077631 0, 87.78865814208984 25.23730087280279 0, 87.79074096679688 25.229621887207088 0, 87.79079437255865 25.22150421142578 0, 87.78836822509771 25.210105895996094 0, 87.78784179687511 25.200637817382926 0, 87.78363037109386 25.18631362915039 0, 87.78215789794922 25.177976608276367 0, 87.77592468261724 25.160686492920036 0, 87.77418518066406 25.153335571289176 0, 87.77436065673828 25.139806747436467 0, 87.77241516113276 25.128093719482536 0, 87.77295684814464 25.115812301635742 0, 87.77578735351574 25.1002197265625 0, 87.77961730957043 25.092403411865348 0, 87.78294372558594 25.08847427368164 0, 87.79595184326178 25.07687759399414 0, 87.80296325683594 25.072383880615348 0, 87.82321929931646 25.062667846679688 0, 87.83794403076178 25.05818748474121 0, 87.84561920166027 25.053373336792106 0, 87.85801696777355 25.047424316406307 0, 87.86730957031256 25.04103660583496 0, 87.87991333007818 25.02924346923828 0, 87.88410949707037 25.022716522216854 0, 87.88375091552746 25.021753311157283 0, 87.89582824707031 25.010171890258903 0, 87.90530395507824 25.000688552856445 0, 87.90592956542963 25.000000000000114 0, 87.90626525878918 24.9996395111084 0, 87.90937805175781 24.98705482482916 0, 87.91638946533214 24.98016166687006 0, 87.92135620117199 24.97410964965826 0, 87.92727661132824 24.968446731567383 0, 87.9331741333009 24.963071823120174 0, 87.941879272461 24.957015991210994 0, 87.9490203857423 24.950180053710994 0, 87.95300292968761 24.946634292602653 0, 87.9590682983399 24.942707061767692 0, 87.96446228027355 24.93722915649414 0, 87.96926879882812 24.930908203125057 0, 87.97274780273438 24.924894332885742 0, 87.97315979003912 24.917387008667106 0, 87.97398376464855 24.91136550903326 0, 87.97502899169922 24.904708862304688 0, 87.97607421875011 24.89782333374029 0, 87.97494506835949 24.892770767211914 0, 87.97209930419933 24.886476516723633 0, 87.96924591064447 24.882661819458008 0, 87.9639663696289 24.88040542602539 0, 87.95510101318371 24.878215789795036 0, 87.94738769531256 24.87403488159191 0, 87.939193725586 24.870967864990348 0, 87.9314956665039 24.867248535156364 0, 87.92431640625006 24.86161613464361 0, 87.91401672363287 24.857311248779297 0, 87.89978790283214 24.85572814941412 0, 87.8917694091798 24.854320526123104 0, 87.89411926269531 24.849540710449162 0, 87.89743804931646 24.849138259887752 0, 87.90054321289074 24.844163894653377 0, 87.9000244140625 24.843141555786133 0, 87.89846801757824 24.840980529785156 0, 87.89772796630854 24.835279464721737 0, 87.89668273925787 24.830562591552678 0, 87.89866638183605 24.82896804809576 0, 87.90118408203125 24.82592391967779 0, 87.89893341064453 24.824001312255916 0, 87.8934783935548 24.824281692504883 0, 87.88932037353527 24.821069717407283 0, 87.8844833374024 24.82179641723627 0, 87.87749481201183 24.82412719726574 0, 87.87204742431646 24.82480430603033 0, 87.8704605102539 24.824377059936523 0, 87.86909484863293 24.822153091430664 0, 87.87092590332037 24.819522857666016 0, 87.87306976318371 24.81664848327648 0, 87.87489318847656 24.81327056884777 0, 87.87548828125006 24.808990478515625 0, 87.87562561035156 24.8066730499267 0, 87.8786087036134 24.804540634155273 0, 87.88037872314453 24.802429199218693 0, 87.88026428222662 24.799428939819393 0, 87.87941741943354 24.795122146606502 0, 87.87751770019531 24.79123115539545 0, 87.87568664550787 24.791210174560604 0, 87.8751068115235 24.793359756469727 0, 87.87282562255865 24.79230308532715 0, 87.87086486816406 24.788528442382812 0, 87.86931610107422 24.783885955810547 0, 87.86760711669922 24.779998779296875 0, 87.86925506591808 24.77759742736822 0, 87.86814880371105 24.775777816772518 0, 87.8627548217774 24.773448944091854 0, 87.86122131347662 24.76926803588873 0, 87.8573226928711 24.765766143798828 0, 87.85298156738287 24.762735366821346 0, 87.84953308105469 24.762504577636776 0, 87.84522247314464 24.764320373535156 0, 87.84163665771496 24.766815185546875 0, 87.83800506591808 24.764684677124023 0, 87.83655548095703 24.76731109619152 0, 87.83656311035156 24.771125793457145 0, 87.83679199218756 24.77608299255371 0, 87.83967590332037 24.77879333496088 0, 87.84179687500011 24.7815780639649 0, 87.84126281738276 24.786149978637695 0, 87.84032440185547 24.789226531982422 0, 87.83648681640636 24.789297103881836 0, 87.83280944824224 24.78440666198742 0, 87.83116912841797 24.77814674377447 0, 87.83064270019531 24.7733669281007 0, 87.82845306396496 24.7707576751709 0, 87.82488250732422 24.768165588378906 0, 87.8208465576173 24.76743507385254 0, 87.818832397461 24.76106834411621 0, 87.81668853759766 24.754819869995174 0, 87.81887054443365 24.753503799438477 0, 87.82327270507818 24.75353813171398 0, 87.82810974121088 24.753679275512695 0, 87.8348999023438 24.747066497802734 0, 87.83344268798822 24.745712280273494 0, 87.82174682617193 24.73431968688965 0, 87.81688690185547 24.729125976562557 0, 87.80575561523449 24.722129821777287 0, 87.79695892333996 24.718517303466854 0, 87.79452514648449 24.718273162841797 0, 87.78862762451166 24.719308853149528 0, 87.78543853759766 24.723249435424805 0, 87.78465270996094 24.726488113403377 0, 87.78317260742193 24.732583999633846 0, 87.781982421875 24.747951507568473 0, 87.77979278564464 24.75184059143072 0, 87.77597045898443 24.752035140991154 0, 87.7717056274414 24.74994468688959 0, 87.7650756835938 24.748804092407283 0, 87.75979614257824 24.749992370605412 0, 87.75507354736328 24.752073287963867 0, 87.74940490722662 24.756875991821403 0, 87.7415771484375 24.771099090576172 0, 87.73293304443354 24.775129318237305 0, 87.72855377197266 24.774427413940487 0, 87.72323608398438 24.771743774414062 0, 87.71996307373041 24.76434707641613 0, 87.71878814697277 24.74476623535162 0, 87.71751403808594 24.74031257629389 0, 87.71309661865229 24.735738754272518 0, 87.7091064453125 24.734832763671932 0, 87.70072937011719 24.736541748046932 0, 87.69000244140636 24.74136734008789 0, 87.68598937988293 24.743675231933707 0, 87.6682739257812 24.755954742431754 0, 87.65547180175793 24.76147842407238 0, 87.6395263671875 24.76743507385254 0, 87.6223373413086 24.77385711669922 0, 87.60633850097656 24.77912330627447 0, 87.597396850586 24.783809661865348 0, 87.59278106689453 24.787351608276367 0, 87.58975982666021 24.7925701141358 0, 87.5879592895509 24.799667358398494 0, 87.59198760986328 24.799560546875114 0, 87.59635925292963 24.79823875427246 0, 87.60403442382812 24.79481697082531 0, 87.60920715332031 24.793548583984432 0, 87.61231231689459 24.79652976989746 0, 87.61293792724621 24.800279617309627 0, 87.61144256591797 24.804040908813477 0, 87.60691833496094 24.80601501464855 0, 87.6002197265625 24.807268142700195 0, 87.587646484375 24.808071136474553 0, 87.57205963134771 24.810958862304744 0, 87.56719970703125 24.81272888183588 0, 87.56375122070307 24.814367294311637 0, 87.54383850097662 24.827552795410213 0, 87.53999328613287 24.827371597290096 0, 87.53827667236334 24.810216903686467 0, 87.5338973999024 24.80434608459484 0, 87.52293395996088 24.79999542236328 0, 87.51145172119152 24.797050476074332 0, 87.5095672607423 24.797695159912166 0, 87.50852203369146 24.797815322876033 0, 87.5095672607423 24.798494338989258 0, 87.50191497802746 24.80176162719721 0, 87.49610137939453 24.805385589599553 0, 87.4925155639649 24.810056686401367 0, 87.48905944824224 24.81484031677246 0, 87.48444366455078 24.818321228027344 0, 87.48186492919933 24.823444366455135 0, 87.48109436035162 24.827781677246207 0, 87.47718811035156 24.831827163696403 0, 87.4759979248048 24.837793350219727 0, 87.47702026367188 24.844814300537166 0, 87.47730255126964 24.84734535217285 0, 87.47393798828125 24.85046195983881 0, 87.47462463378918 24.855125427246094 0, 87.47028350830072 24.854846954345703 0, 87.47245025634766 24.85711860656744 0, 87.47698974609375 24.858257293701172 0, 87.475830078125 24.860813140869197 0, 87.47236633300793 24.860761642455998 0, 87.46730804443365 24.858591079711914 0, 87.46308135986328 24.86304283142084 0, 87.45752716064453 24.861921310424805 0, 87.45688629150402 24.871103286743278 0, 87.46546173095714 24.873388290405273 0, 87.46562957763678 24.87701988220215 0, 87.46184539794933 24.88066482543951 0, 87.4571762084961 24.884893417358455 0, 87.45414733886724 24.888980865478516 0, 87.45246887207037 24.894430160522518 0, 87.4579086303711 24.896650314331055 0, 87.46166229248058 24.899068832397575 0, 87.46469879150402 24.903236389160213 0, 87.46635437011724 24.90771102905279 0, 87.4668960571289 24.91208648681652 0, 87.46740722656261 24.917217254638672 0, 87.46226501464855 24.918045043945312 0, 87.45752716064453 24.917375564575195 0, 87.45671844482433 24.923740386962947 0, 87.45684051513678 24.92852783203125 0, 87.45664215087896 24.93332481384283 0, 87.45994567871105 24.937887191772518 0, 87.46008300781256 24.94320869445812 0, 87.46399688720697 24.947877883911133 0, 87.4634780883789 24.953212738037053 0, 87.4695816040039 24.954618453979492 0, 87.47111511230469 24.961996078491325 0, 87.47264099121094 24.96845626831066 0, 87.4750213623048 24.968076705932674 0, 87.4754638671875 24.972761154174805 0, 87.47561645507824 24.978319168090934 0, 87.47476196289068 24.98291015625 0, 87.47052001953125 24.98563957214367 0, 87.46631622314453 24.987503051757812 0, 87.46451568603527 24.99030113220215 0, 87.46627044677746 24.994209289550838 0, 87.47140502929699 25.000000000000114 0, 87.47255706787121 25.001300811767578 0, 87.48029327392584 25.012166976928825 0, 87.4864120483399 25.01555061340332 0, 87.4896926879884 25.016050338745117 0, 87.49566650390625 25.019266128540096 0, 87.50321197509771 25.027896881103572 0, 87.50855255126959 25.040630340576172 0, 87.50431060791021 25.052537918090763 0, 87.50711822509766 25.05633544921875 0, 87.50751495361328 25.05528831481945 0, 87.51207733154297 25.054931640625114 0, 87.51673126220709 25.057796478271484 0, 87.52058410644543 25.058221817016715 0, 87.517318725586 25.06237220764166 0, 87.50965118408209 25.06619262695324 0, 87.50027465820312 25.075767517089787 0, 87.49633789062506 25.083110809326115 0, 87.49276733398449 25.086074829101562 0, 87.48993682861322 25.094409942626953 0, 87.48429870605474 25.098892211914062 0, 87.47731018066418 25.10124397277832 0, 87.47396087646484 25.106491088867188 0, 87.49781799316406 25.137647628784293 0, 87.492431640625 25.153333663940373 0, 87.48100280761719 25.17547798156744 0, 87.47564697265625 25.19562911987299 0, 87.47533416748053 25.223312377929744 0, 87.47655487060558 25.23234939575201 0, 87.47617340087902 25.241796493530387 0, 87.49110412597656 25.26289558410656 0, 87.49835968017578 25.260593414306697 0, 87.49924468994152 25.263380050659293 0, 87.49911499023438 25.266202926635856 0, 87.49549865722656 25.27232933044445 0, 87.49800872802734 25.276319503784293 0, 87.49112701416016 25.278490066528377 0, 87.48506164550787 25.296039581298885 0, 87.48995208740234 25.29694557189947 0, 87.493637084961 25.306060791015682 0, 87.50241851806646 25.293167114257926 0, 87.51639556884777 25.293020248413086 0, 87.52903747558588 25.28187561035162 0, 87.53293609619146 25.280509948730526 0, 87.5391311645509 25.281007766723746 0, 87.54322814941412 25.28252029418951 0, 87.542007446289 25.297115325927678 0, 87.54464721679699 25.305128097534293 0, 87.54763793945318 25.32375526428217 0, 87.55033111572271 25.32451629638672 0, 87.55097961425781 25.33179855346691 0, 87.57062530517578 25.334749221801815 0, 87.58299255371105 25.344776153564567 0, 87.5911483764649 25.34140777587902 0, 87.5927734375 25.324657440185604 0, 87.61706542968756 25.316427230834904 0, 87.62627410888683 25.311927795410156 0, 87.65249633789062 25.2991104125976 0, 87.68417358398443 25.28359603881836 0))",both
PAKUR,899200,453101,446099,498,"POLYGON Z ((87.50852203369146 24.797815322876033 0, 87.5095672607423 24.797695159912166 0, 87.51145172119152 24.797050476074332 0, 87.52293395996088 24.79999542236328 0, 87.5338973999024 24.80434608459484 0, 87.53827667236334 24.810216903686467 0, 87.53999328613287 24.827371597290096 0, 87.54383850097662 24.827552795410213 0, 87.56375122070307 24.814367294311637 0, 87.56719970703125 24.81272888183588 0, 87.57205963134771 24.810958862304744 0, 87.587646484375 24.808071136474553 0, 87.6002197265625 24.807268142700195 0, 87.60691833496094 24.80601501464855 0, 87.61144256591797 24.804040908813477 0, 87.61293792724621 24.800279617309627 0, 87.61231231689459 24.79652976989746 0, 87.60920715332031 24.793548583984432 0, 87.60403442382812 24.79481697082531 0, 87.59635925292963 24.79823875427246 0, 87.59198760986328 24.799560546875114 0, 87.5879592895509 24.799667358398494 0, 87.58975982666021 24.7925701141358 0, 87.59278106689453 24.787351608276367 0, 87.597396850586 24.783809661865348 0, 87.60633850097656 24.77912330627447 0, 87.6223373413086 24.77385711669922 0, 87.6395263671875 24.76743507385254 0, 87.65547180175793 24.76147842407238 0, 87.6682739257812 24.755954742431754 0, 87.68598937988293 24.743675231933707 0, 87.69000244140636 24.74136734008789 0, 87.70072937011719 24.736541748046932 0, 87.7091064453125 24.734832763671932 0, 87.71309661865229 24.735738754272518 0, 87.71751403808594 24.74031257629389 0, 87.71878814697277 24.74476623535162 0, 87.71996307373041 24.76434707641613 0, 87.72323608398438 24.771743774414062 0, 87.72855377197266 24.774427413940487 0, 87.73293304443354 24.775129318237305 0, 87.7415771484375 24.771099090576172 0, 87.74940490722662 24.756875991821403 0, 87.75507354736328 24.752073287963867 0, 87.75979614257824 24.749992370605412 0, 87.7650756835938 24.748804092407283 0, 87.7717056274414 24.74994468688959 0, 87.77597045898443 24.752035140991154 0, 87.77979278564464 24.75184059143072 0, 87.781982421875 24.747951507568473 0, 87.78317260742193 24.732583999633846 0, 87.78465270996094 24.726488113403377 0, 87.78543853759766 24.723249435424805 0, 87.78862762451166 24.719308853149528 0, 87.79452514648449 24.718273162841797 0, 87.79695892333996 24.718517303466854 0, 87.80575561523449 24.722129821777287 0, 87.81688690185547 24.729125976562557 0, 87.82174682617193 24.73431968688965 0, 87.83344268798822 24.745712280273494 0, 87.8348999023438 24.747066497802734 0, 87.84247589111328 24.73967361450201 0, 87.85509490966803 24.73643112182623 0, 87.86375427246105 24.732746124267578 0, 87.8701171875 24.730894088745117 0, 87.87358856201178 24.731525421142692 0, 87.87765502929699 24.736576080322266 0, 87.88049316406256 24.740568161010856 0, 87.8851547241211 24.737764358520565 0, 87.8869247436524 24.73496055603033 0, 87.88815307617199 24.73078536987316 0, 87.88989257812511 24.726940155029354 0, 87.89347076416027 24.72410392761236 0, 87.89832305908203 24.72452735900879 0, 87.90351104736328 24.723102569580135 0, 87.90483093261719 24.720010757446346 0, 87.90599822998053 24.716068267822322 0, 87.9058227539063 24.71342277526861 0, 87.90559387207031 24.71145820617687 0, 87.90359497070324 24.712015151977596 0, 87.90150451660168 24.711421966552734 0, 87.90018463134777 24.707990646362305 0, 87.89884185791027 24.703975677490234 0, 87.9016799926759 24.7012042999267 0, 87.90045166015625 24.69649887084961 0, 87.89922332763683 24.69219589233404 0, 87.89541625976574 24.68729972839361 0, 87.892074584961 24.68332862854004 0, 87.88891601562511 24.67964363098139 0, 87.88928222656261 24.675647735595817 0, 87.8930282592774 24.671882629394588 0, 87.89770507812511 24.67006492614746 0, 87.90255737304688 24.6708927154541 0, 87.90583801269537 24.668518066406364 0, 87.90911102294933 24.665924072265625 0, 87.91422271728521 24.663856506347713 0, 87.91602325439464 24.660129547119197 0, 87.91274261474621 24.656505584716854 0, 87.9114761352539 24.652885437011832 0, 87.9104461669923 24.648410797119084 0, 87.91059112548834 24.64367866516119 0, 87.91030120849621 24.63837242126465 0, 87.9088973999024 24.63424110412609 0, 87.90689849853516 24.63203430175787 0, 87.90462493896484 24.631032943725643 0, 87.90261077880865 24.631019592285156 0, 87.89949798583984 24.632003784179744 0, 87.89488983154297 24.63364410400385 0, 87.8914794921875 24.633018493652457 0, 87.88943481445318 24.63109779357916 0, 87.88723754882807 24.628252029419002 0, 87.88977813720703 24.62607383728033 0, 87.8943939208985 24.62528800964361 0, 87.89799499511724 24.626089096069393 0, 87.9014739990235 24.627347946166992 0, 87.9048690795899 24.62751197814947 0, 87.9044189453125 24.624176025390682 0, 87.90399169921886 24.62163925170904 0, 87.9047317504884 24.618112564086914 0, 87.9042129516601 24.61419677734375 0, 87.90205383300793 24.61302566528326 0, 87.89892578125 24.613485336303768 0, 87.89644622802734 24.61457633972168 0, 87.89379119873053 24.613821029663086 0, 87.89088439941406 24.61295509338379 0, 87.88813781738293 24.6134090423584 0, 87.88478088378906 24.615205764770508 0, 87.88172912597656 24.616365432739258 0, 87.87962341308594 24.617900848388615 0, 87.87747192382824 24.617134094238338 0, 87.87611389160168 24.61508560180664 0, 87.87536621093761 24.612331390380973 0, 87.87615966796886 24.610929489135742 0, 87.8779296875 24.61152458190918 0, 87.87859344482433 24.610477447509766 0, 87.88060760498047 24.611072540283203 0, 87.88382720947266 24.60859107971197 0, 87.88874816894543 24.606761932373104 0, 87.89063262939464 24.606956481933594 0, 87.8913192749024 24.609832763671875 0, 87.89608764648443 24.60996246337902 0, 87.90129852294933 24.60969161987299 0, 87.90550231933605 24.60966682434082 0, 87.91071319580078 24.609800338745117 0, 87.91032409667969 24.606000900268555 0, 87.9102172851563 24.60103797912609 0, 87.9117279052735 24.598011016845817 0, 87.91255187988293 24.59550857543951 0, 87.91130828857422 24.592821121215934 0, 87.90940856933594 24.588996887206974 0, 87.9080200195312 24.585447311401424 0, 87.90586090087896 24.584045410156193 0, 87.90199279785162 24.585216522216854 0, 87.89996337890636 24.584096908569393 0, 87.89867401123041 24.582275390625114 0, 87.89407348632824 24.581272125244084 0, 87.89283752441412 24.57638931274414 0, 87.89247131347662 24.57356452941906 0, 87.889907836914 24.564382553100586 0, 87.88332366943365 24.564626693725643 0, 87.8791961669923 24.562746047973633 0, 87.8712387084961 24.5629501342774 0, 87.86846160888678 24.56248474121088 0, 87.8670425415039 24.560382843017635 0, 87.86649322509766 24.558256149291935 0, 87.86307525634766 24.556938171386832 0, 87.85892486572271 24.5562686920166 0, 87.85638427734375 24.557701110839957 0, 87.8530883789062 24.559494018554688 0, 87.85181427001953 24.55859184265148 0, 87.8525619506836 24.55540466308605 0, 87.85081481933594 24.552726745605582 0, 87.84758758544922 24.554460525512752 0, 87.84372711181652 24.556091308593807 0, 87.83743286132824 24.55799865722662 0, 87.8296279907226 24.559822082519474 0, 87.82714843749994 24.56114196777355 0, 87.82652282714855 24.565017700195312 0, 87.82590484619146 24.568202972412166 0, 87.82279968261719 24.570053100585994 0, 87.8195190429687 24.571722030639705 0, 87.81686401367188 24.574256896972713 0, 87.81433105468761 24.57609367370611 0, 87.81166839599621 24.577869415283203 0, 87.80767822265636 24.57916641235363 0, 87.80493164062506 24.579673767089844 0, 87.80158996582026 24.57944869995123 0, 87.79773712158214 24.58130836486822 0, 87.79337310791027 24.58271598815918 0, 87.7880630493164 24.58396720886242 0, 87.78235626220703 24.583730697631893 0, 87.77211761474615 24.583395004272575 0, 87.77062988281256 24.577653884887695 0, 87.77028656005871 24.57321739196783 0, 87.77587127685547 24.573522567749023 0, 87.78044891357422 24.573028564453125 0, 87.78842163085949 24.570232391357422 0, 87.7942733764649 24.567350387573356 0, 87.79884338378912 24.56403350830078 0, 87.80203247070312 24.560569763183707 0, 87.80526733398438 24.555952072143498 0, 87.80748748779308 24.55089187622076 0, 87.80898284912121 24.54688262939453 0, 87.80842590332043 24.5441188812257 0, 87.80624389648443 24.541797637939396 0, 87.80250549316418 24.542850494384822 0, 87.80013275146484 24.540351867675895 0, 87.80062866210949 24.537050247192383 0, 87.79978179931646 24.531702041625977 0, 87.80023193359386 24.526330947875977 0, 87.8016586303711 24.522611618041992 0, 87.80385589599621 24.51939392089838 0, 87.8037948608399 24.516336441040153 0, 87.80235290527338 24.513423919677734 0, 87.80112457275396 24.51113891601574 0, 87.80113983154303 24.50871658325201 0, 87.80258178710938 24.505970001220703 0, 87.80085754394531 24.504156112670955 0, 87.79661560058605 24.502048492431697 0, 87.79524230957043 24.49895668029791 0, 87.7964324951173 24.495990753173942 0, 87.79775238037121 24.492790222168026 0, 87.80115509033214 24.49359321594244 0, 87.80364990234386 24.4965496063233 0, 87.80561828613281 24.500381469726562 0, 87.80605316162115 24.50337028503418 0, 87.80636596679682 24.506483078002987 0, 87.80654144287121 24.508953094482536 0, 87.80789947509766 24.511352539062614 0, 87.80929565429693 24.512315750122127 0, 87.81021881103516 24.511081695556584 0, 87.80995941162121 24.507913589477596 0, 87.81093597412104 24.506282806396598 0, 87.81282806396496 24.503757476806697 0, 87.81440734863281 24.500732421875 0, 87.81372070312506 24.498149871826172 0, 87.81262207031261 24.496265411376953 0, 87.81282043457043 24.493835449218693 0, 87.8148803710938 24.49333381652832 0, 87.8181610107423 24.49454498291027 0, 87.82128143310547 24.493791580200252 0, 87.82281494140625 24.495208740234375 0, 87.82235717773449 24.49764060974121 0, 87.82450866699219 24.498176574707145 0, 87.82547760009766 24.496139526367188 0, 87.82505035400385 24.494073867797795 0, 87.82405853271496 24.491834640503043 0, 87.82359313964844 24.49017524719244 0, 87.82285308837896 24.487594604492188 0, 87.81947326660168 24.487823486328182 0, 87.81562805175787 24.48686408996582 0, 87.81295776367193 24.482116699218807 0, 87.81169891357416 24.478340148925895 0, 87.81398773193354 24.476568222046012 0, 87.81632232666016 24.474498748779297 0, 87.81739807128918 24.471820831298828 0, 87.82043457031261 24.47021484375 0, 87.81918334960938 24.467229843139762 0, 87.8203125 24.464090347290153 0, 87.81993865966797 24.460760116577262 0, 87.81874084472668 24.457082748413143 0, 87.81782531738281 24.455375671386776 0, 87.81752777099615 24.453128814697266 0, 87.8138427734375 24.453655242920036 0, 87.80946350097656 24.45437431335455 0, 87.80509948730474 24.45192146301264 0, 87.80352783203125 24.44917869567871 0, 87.80230712890636 24.447237014770565 0, 87.80245971679693 24.44550514221197 0, 87.79947662353527 24.443656921386662 0, 87.79854583740229 24.441192626953068 0, 87.79549407958979 24.441595077514705 0, 87.79362487792969 24.43955421447754 0, 87.79238128662121 24.436458587646598 0, 87.7906951904298 24.43389701843256 0, 87.79296875000011 24.4312038421632 0, 87.79486083984386 24.428680419921932 0, 87.79479980468756 24.425622940063477 0, 87.79262542724604 24.423475265502987 0, 87.78880310058605 24.420429229736385 0, 87.78734588623047 24.416357040405273 0, 87.79048156738293 24.41335487365734 0, 87.79553985595703 24.41245460510254 0, 87.8011932373048 24.413042068481445 0, 87.80392456054688 24.41524314880371 0, 87.80778503417974 24.419965744018498 0, 87.80896759033209 24.416536331176815 0, 87.81104278564459 24.41395187377941 0, 87.81156158447266 24.411058425903434 0, 87.8125610351563 24.408449172973633 0, 87.81001281738281 24.406185150146428 0, 87.80680084228516 24.405374526977482 0, 87.80406951904291 24.40375709533697 0, 87.80077362060558 24.401569366455192 0, 87.79734039306652 24.401918411254996 0, 87.79513549804688 24.398269653320256 0, 87.79518890380865 24.394922256469727 0, 87.79724884033203 24.39401626586914 0, 87.79987335205072 24.39414787292486 0, 87.80066680908203 24.39262580871582 0, 87.80012512207031 24.387907028198356 0, 87.80005645751964 24.384040832519588 0, 87.79633331298834 24.3826141357423 0, 87.79249572753906 24.37887001037592 0, 87.79019927978516 24.37354660034191 0, 87.78749084472656 24.369501113891715 0, 87.78490447998053 24.36210823059082 0, 87.78177642822266 24.358934402465877 0, 87.77914428710938 24.355293273925838 0, 87.77517700195318 24.351266860961914 0, 87.77197265625011 24.347286224365234 0, 87.77043151855474 24.34235954284668 0, 87.76706695556635 24.3404598236084 0, 87.76377868652355 24.335210800170955 0, 87.76311492919922 24.33008193969721 0, 87.76675415039062 24.32713699340826 0, 87.76702117919933 24.324703216552848 0, 87.76502990722656 24.322601318359375 0, 87.76263427734386 24.321437835693416 0, 87.76201629638678 24.31879806518566 0, 87.7628784179687 24.314968109130973 0, 87.76103210449219 24.30975914001465 0, 87.75881958007824 24.305528640747127 0, 87.75464630126964 24.30658721923828 0, 87.75076293945318 24.303424835205078 0, 87.74829864501959 24.30173873901373 0, 87.74568939208996 24.29965400695812 0, 87.74301910400402 24.2946834564209 0, 87.73876190185553 24.293949127197322 0, 87.73894500732428 24.290891647338867 0, 87.73561096191406 24.289855957031307 0, 87.73271942138683 24.289558410644474 0, 87.72975158691406 24.288175582885685 0, 87.7265243530274 24.28944015502941 0, 87.72233581542974 24.28998184204113 0, 87.71830749511719 24.29195785522461 0, 87.71289825439447 24.29401779174816 0, 87.71266937255871 24.2885360717774 0, 87.71203613281256 24.284864425659237 0, 87.71092987060553 24.282344818115348 0, 87.70875549316406 24.280075073242188 0, 87.70719146728516 24.27646446228033 0, 87.70801544189459 24.27367973327631 0, 87.70856475830078 24.269805908203182 0, 87.70710754394537 24.265731811523438 0, 87.70521545410168 24.261905670166072 0, 87.69996643066406 24.261713027954215 0, 87.69559478759766 24.25936889648449 0, 87.6912460327149 24.257595062255803 0, 87.68756866455078 24.254837036132756 0, 87.6856689453125 24.250537872314396 0, 87.68394470214844 24.24843597412115 0, 87.68050384521484 24.248445510864258 0, 87.67644500732433 24.24868774414074 0, 87.67327117919922 24.24626159667963 0, 87.6713638305664 24.24473571777338 0, 87.66799926757818 24.245487213134822 0, 87.66452026367188 24.246944427490234 0, 87.66289520263683 24.243972778320256 0, 87.6616439819336 24.240360260009822 0, 87.65964508056652 24.237392425537053 0, 87.65692901611334 24.238590240478516 0, 87.65454864501953 24.242151260375977 0, 87.65248107910156 24.245653152465877 0, 87.65191650390625 24.248605728149414 0, 87.64976501464838 24.25054740905773 0, 87.64435577392584 24.251852035522518 0, 87.63282012939453 24.257131576538086 0, 87.6227645874024 24.258459091186523 0, 87.61520385742199 24.25882720947277 0, 87.60708618164062 24.25654411315918 0, 87.60170745849604 24.256574630737305 0, 87.59359741210943 24.25856399536127 0, 87.58626556396484 24.25793838500988 0, 87.5819702148438 24.258939743042106 0, 87.58355712890636 24.27050399780279 0, 87.58369445800787 24.281290054321346 0, 87.58393859863293 24.291904449463004 0, 87.58448791503918 24.305393218994197 0, 87.58555603027344 24.31559181213379 0, 87.58671569824224 24.32497787475586 0, 87.585189819336 24.330423355102482 0, 87.5819320678711 24.34029197692871 0, 87.57936859130871 24.351524353027457 0, 87.57520294189453 24.36700057983404 0, 87.5711822509765 24.380397796630973 0, 87.56996154785162 24.396631240844727 0, 87.56752777099621 24.418373107910213 0, 87.56707000732428 24.434589385986442 0, 87.566879272461 24.455770492553825 0, 87.56757354736328 24.470006942749023 0, 87.56469726562494 24.4777889251709 0, 87.56637573242199 24.487514495849666 0, 87.56712341308605 24.49373245239252 0, 87.56842803955084 24.50074386596691 0, 87.57178497314453 24.5056533813476 0, 87.56847381591808 24.50997543334961 0, 87.56607055664062 24.51607894897461 0, 87.56233215332037 24.521272659301815 0, 87.5547332763673 24.520654678344783 0, 87.54516601562506 24.518224716186523 0, 87.54068756103516 24.513391494750977 0, 87.53677368164068 24.508152008056697 0, 87.5348129272461 24.50754928588873 0, 87.5311508178711 24.509691238403434 0, 87.52613830566418 24.513233184814453 0, 87.5178833007813 24.514350891113338 0, 87.5099868774414 24.517885208129996 0, 87.50315856933594 24.52244186401373 0, 87.49781799316406 24.525699615478572 0, 87.48977661132812 24.52842903137207 0, 87.48207092285168 24.52890777587902 0, 87.47860717773443 24.52797889709484 0, 87.4754104614259 24.524682998657283 0, 87.46892547607433 24.523117065429744 0, 87.46302795410168 24.522470474243278 0, 87.45783996582043 24.520187377929688 0, 87.45527648925781 24.520460128784293 0, 87.45071411132818 24.521800994873047 0, 87.44837188720703 24.520401000976562 0, 87.44574737548828 24.517435073852596 0, 87.44336700439464 24.517013549804744 0, 87.43823242187511 24.517562866210994 0, 87.43458557128918 24.51761627197277 0, 87.43155670166027 24.515882492065543 0, 87.4297103881836 24.514528274536133 0, 87.42683410644531 24.514913558960075 0, 87.42369079589855 24.514511108398494 0, 87.42038726806646 24.511789321899528 0, 87.41694641113281 24.50832557678234 0, 87.41516113281244 24.506849288940487 0, 87.40318298339844 24.506467819213924 0, 87.39542388916021 24.511264801025504 0, 87.391586303711 24.514551162719783 0, 87.38821411132824 24.51910781860346 0, 87.3874130249024 24.52396774291998 0, 87.38813018798828 24.52903556823742 0, 87.38991546630865 24.53546905517578 0, 87.39028167724615 24.5422744750976 0, 87.38958740234386 24.545921325683594 0, 87.39293670654303 24.547479629516545 0, 87.39750671386724 24.546886444091854 0, 87.4005355834961 24.544181823730412 0, 87.40293121337902 24.540973663330135 0, 87.4039306640625 24.537208557128963 0, 87.40607452392578 24.53740882873535 0, 87.40650177001959 24.540912628173828 0, 87.40726470947271 24.544830322265682 0, 87.40955352783209 24.546869277954215 0, 87.41481018066406 24.54632568359375 0, 87.41819000244152 24.549274444580078 0, 87.4199447631836 24.553220748901424 0, 87.42156219482428 24.55619430541998 0, 87.42572784423834 24.55803871154791 0, 87.43202972412115 24.55961227416998 0, 87.43643188476568 24.560056686401424 0, 87.43846893310547 24.56585121154785 0, 87.44470977783214 24.564020156860465 0, 87.45043182373058 24.564563751220703 0, 87.45619201660156 24.567354202270508 0, 87.46010589599615 24.56861686706543 0, 87.46369934082037 24.570228576660213 0, 87.46653747558594 24.574975967407227 0, 87.46704864501947 24.578598022460994 0, 87.46338653564464 24.581426620483455 0, 87.45928192138672 24.583230972290096 0, 87.45531463623053 24.586116790771484 0, 87.45503234863276 24.591489791870117 0, 87.45510101318365 24.596334457397518 0, 87.4638061523437 24.602483749389762 0, 87.46138763427734 24.610889434814453 0, 87.45928955078125 24.616748809814396 0, 87.45073699951178 24.61660003662115 0, 87.44782257080078 24.61843681335455 0, 87.44705963134766 24.621337890625057 0, 87.446762084961 24.626131057739315 0, 87.4488983154298 24.630311965942383 0, 87.452621459961 24.63475036621105 0, 87.45845794677729 24.63840484619135 0, 87.46387481689459 24.64345550537115 0, 87.4673461914063 24.64795684814453 0, 87.46985626220714 24.65183830261236 0, 87.47123718261713 24.659088134765682 0, 87.47037506103521 24.667694091796932 0, 87.46933746337885 24.673370361328125 0, 87.46707916259766 24.680673599243164 0, 87.47038269042974 24.686508178710938 0, 87.46881103515625 24.693630218505803 0, 87.46703338623058 24.69988441467285 0, 87.46337127685558 24.706178665161133 0, 87.46262359619152 24.710693359374943 0, 87.46277618408209 24.715707778930607 0, 87.4619140625 24.720743179321346 0, 87.46041870117188 24.72474670410162 0, 87.4547805786134 24.725942611694336 0, 87.45489501953125 24.728878021240348 0, 87.45735168457031 24.732881546020508 0, 87.45470428466797 24.735979080200195 0, 87.45137786865246 24.739955902099723 0, 87.44620513916027 24.74627494812023 0, 87.44214630126959 24.751300811767635 0, 87.4382553100586 24.751594543457088 0, 87.4354476928711 24.753141403198356 0, 87.43500518798822 24.7568416595459 0, 87.43627929687511 24.76178169250494 0, 87.44075775146484 24.765979766845703 0, 87.44618988037115 24.771436691284293 0, 87.45061492919933 24.77666854858404 0, 87.45415496826178 24.781520843505973 0, 87.45703125000006 24.78822708129877 0, 87.45937347412121 24.79303550720209 0, 87.4628372192384 24.79331779479986 0, 87.46775817871105 24.79058265686041 0, 87.47357940673828 24.789400100708065 0, 87.47840118408209 24.78845405578619 0, 87.48110198974621 24.78863716125494 0, 87.48324584960949 24.788772583007812 0, 87.4849319458009 24.78823089599615 0, 87.48735809326178 24.786054611206055 0, 87.49059295654303 24.784843444824332 0, 87.49385070800787 24.784385681152344 0, 87.49716949462902 24.786579132080078 0, 87.494888305664 24.78915977478033 0, 87.499008178711 24.791627883911133 0, 87.50852203369146 24.797815322876033 0))",both
DHANBAD,2682662,1405847,1276815,1284,"POLYGON Z ((86.11687469482422 23.894491195678654 0, 86.11814880371105 23.896011352539176 0, 86.12158203125011 23.89783477783203 0, 86.1249618530274 23.90290260314947 0, 86.12622833251953 23.910902023315373 0, 86.12923431396479 23.913105010986442 0, 86.12757873535156 23.91937637329113 0, 86.1320190429688 23.931713104248104 0, 86.13497161865234 23.937004089355526 0, 86.149658203125 23.93540000915533 0, 86.15834808349615 23.938175201416016 0, 86.16279602050776 23.93852424621582 0, 86.17046356201172 23.94317245483404 0, 86.17847442626953 23.945552825927678 0, 86.18388366699224 23.94561576843256 0, 86.19558715820324 23.94889831542963 0, 86.2028274536134 23.948303222656364 0, 86.21056365966803 23.94543647766119 0, 86.22010803222662 23.946704864501896 0, 86.23914337158203 23.943840026855526 0, 86.24320983886724 23.942594528198242 0, 86.25675201416021 23.931808471679744 0, 86.26048278808594 23.930534362793082 0, 86.26667785644537 23.93017005920416 0, 86.2722625732423 23.93272209167486 0, 86.27751159667974 23.933578491210994 0, 86.29046630859375 23.91475486755371 0, 86.28781127929693 23.946392059326172 0, 86.29856872558605 23.9672794342041 0, 86.30057525634766 23.97480201721197 0, 86.30280303955072 23.97834396362316 0, 86.30088043212902 23.984514236450252 0, 86.30290985107428 23.990951538085994 0, 86.31315612792969 23.998170852661133 0, 86.32092285156244 24.00704574584961 0, 86.3240585327149 24.011362075805664 0, 86.32588195800776 24.01379776000988 0, 86.32985687255871 24.016872406005973 0, 86.33367919921886 24.01845932006836 0, 86.33821868896496 24.019197463989258 0, 86.34020233154297 24.02161026000988 0, 86.34053802490246 24.024114608764705 0, 86.34002685546875 24.027196884155387 0, 86.33525848388672 24.028224945068416 0, 86.33057403564459 24.028875350952205 0, 86.32720184326183 24.030296325683707 0, 86.32429504394543 24.033142089843807 0, 86.32125091552746 24.034616470336914 0, 86.31931304931646 24.03623962402355 0, 86.3202514648438 24.037990570068416 0, 86.32811737060558 24.040994644165096 0, 86.33290100097668 24.042139053344783 0, 86.33419799804693 24.04321670532221 0, 86.33357238769531 24.047361373901424 0, 86.33597564697277 24.050315856933707 0, 86.33438110351568 24.052848815917912 0, 86.34162139892584 24.05502891540533 0, 86.3469848632813 24.05596351623535 0, 86.35185241699219 24.054325103759766 0, 86.35832214355469 24.051818847656307 0, 86.3663940429688 24.05121994018549 0, 86.37080383300787 24.05402374267578 0, 86.37516784667974 24.059104919433707 0, 86.37991333007812 24.06011199951172 0, 86.38498687744152 24.05950546264654 0, 86.38833618164068 24.055089950561467 0, 86.39098358154297 24.048456192016715 0, 86.39647674560547 24.04102897644043 0, 86.40392303466797 24.038436889648494 0, 86.41235351562506 24.035406112671012 0, 86.42156982421886 24.030467987060547 0, 86.42561340332043 24.029954910278434 0, 86.43222045898443 24.03110885620123 0, 86.43857574462902 24.0319766998291 0, 86.44379425048828 24.03082084655773 0, 86.4488143920899 24.027994155883846 0, 86.45519256591791 24.02284240722662 0, 86.4616928100586 24.019947052001896 0, 86.46858215332031 24.018484115600586 0, 86.47164154052734 24.015832901001033 0, 86.47521209716808 24.013740539550724 0, 86.47814178466797 24.01170158386236 0, 86.48062133789062 24.010808944702262 0, 86.4837036132813 24.01110458374029 0, 86.48595428466797 24.011922836303768 0, 86.4889526367187 24.013422012329045 0, 86.49060058593756 24.014163970947322 0, 86.49270629882818 24.01469421386713 0, 86.49447631835949 24.014373779296875 0, 86.49609375000006 24.01345062255865 0, 86.49813079833984 24.012027740478572 0, 86.49972534179693 24.01033973693859 0, 86.50222778320318 24.007659912109375 0, 86.51512145996094 24.00098991394043 0, 86.52216339111328 23.999565124511776 0, 86.53984832763683 24.006134033203125 0, 86.57159423828125 24.002079010009766 0, 86.57744598388683 23.999656677246094 0, 86.58460998535162 23.990736007690487 0, 86.59447479248047 23.981025695800838 0, 86.59790802001953 23.975257873535156 0, 86.64000701904308 23.952318191528377 0, 86.64511871337902 23.946441650390625 0, 86.65582275390636 23.940561294555607 0, 86.67008209228521 23.937160491943303 0, 86.68769836425776 23.926017761230412 0, 86.70443725585949 23.9235076904298 0, 86.71041107177734 23.91750907897955 0, 86.71718597412115 23.907581329345817 0, 86.71971130371105 23.892585754394645 0, 86.72242736816406 23.88462448120123 0, 86.72879028320318 23.876956939697266 0, 86.73166656494146 23.87499809265148 0, 86.74101257324224 23.88175582885748 0, 86.74649047851562 23.884315490722713 0, 86.76342773437494 23.878997802734432 0, 86.76727294921875 23.87661933898937 0, 86.77098846435553 23.87303924560547 0, 86.77515411376959 23.86695861816412 0, 86.78034973144543 23.863296508789062 0, 86.78435516357433 23.858499526977653 0, 86.79611206054693 23.833679199218864 0, 86.79546356201166 23.82955360412592 0, 86.80072784423834 23.826356887817383 0, 86.80422973632824 23.81566047668457 0, 86.80093383789068 23.800073623657283 0, 86.81163787841808 23.790636062622013 0, 86.8199462890625 23.77853393554699 0, 86.8229751586914 23.763475418090877 0, 86.82254028320324 23.754680633544922 0, 86.81929016113293 23.74725532531744 0, 86.81483459472662 23.747220993042106 0, 86.81122589111334 23.746248245239258 0, 86.80773162841797 23.74227523803711 0, 86.8015594482423 23.718799591064453 0, 86.79669952392584 23.708477020263615 0, 86.79414367675781 23.70098114013672 0, 86.79623413085932 23.69749832153326 0, 86.79885864257824 23.695959091186523 0, 86.79521942138683 23.6898651123048 0, 86.77591705322271 23.684370040893555 0, 86.7617416381836 23.68097686767578 0, 86.74136352539062 23.680101394653377 0, 86.73916625976574 23.68157768249523 0, 86.73979949951172 23.691232681274528 0, 86.73494720458996 23.6962566375733 0, 86.71428680419928 23.69968605041504 0, 86.69714355468756 23.696971893310604 0, 86.68666076660162 23.69219970703125 0, 86.67205047607433 23.688508987426815 0, 86.65218353271496 23.68531990051281 0, 86.636703491211 23.678197860717717 0, 86.62779235839855 23.67522430419922 0, 86.61917114257824 23.674093246460018 0, 86.59497833251964 23.673597335815543 0, 86.59133911132824 23.671524047851676 0, 86.59189605712902 23.667894363403377 0, 86.59400177001964 23.664699554443416 0, 86.58650207519537 23.661302566528434 0, 86.5686492919923 23.64874649047863 0, 86.55542755126959 23.64256286621105 0, 86.54084777832031 23.637090682983455 0, 86.5320816040039 23.631462097168082 0, 86.52713012695312 23.630844116210994 0, 86.51532745361328 23.631534576416072 0, 86.5051651000976 23.634046554565487 0, 86.4847564697265 23.637502670288143 0, 86.47510528564459 23.633731842041016 0, 86.46990203857422 23.632078170776367 0, 86.4484252929688 23.633975982666072 0, 86.4433822631836 23.632059097290096 0, 86.44199371337902 23.630237579345817 0, 86.44142913818371 23.62663459777832 0, 86.44240570068371 23.622219085693473 0, 86.43856811523449 23.624217987060547 0, 86.43180084228516 23.63134002685547 0, 86.42440795898443 23.640844345092773 0, 86.4203109741211 23.659267425537053 0, 86.41397857666027 23.662668228149414 0, 86.40767669677746 23.664775848388786 0, 86.40122985839844 23.66587448120123 0, 86.39514923095703 23.668434143066463 0, 86.38918304443371 23.672155380249023 0, 86.38446807861328 23.675956726074162 0, 86.38052368164068 23.68038368225092 0, 86.37752532958996 23.684856414794922 0, 86.37486267089855 23.691404342651367 0, 86.36949920654308 23.702505111694393 0, 86.35454559326172 23.702230453491154 0, 86.31065368652344 23.704759597778434 0, 86.30581665039074 23.704221725463924 0, 86.29722595214855 23.704484939575195 0, 86.27344512939453 23.707489013671875 0, 86.2605819702149 23.706449508666992 0, 86.2564697265625 23.708461761474723 0, 86.24161529541016 23.70743942260748 0, 86.23128509521484 23.707433700561523 0, 86.22225952148449 23.707998275756836 0, 86.21167755126953 23.709457397460994 0, 86.20644378662121 23.71143913269043 0, 86.20232391357422 23.712787628173885 0, 86.19568634033209 23.71637535095215 0, 86.18543243408209 23.719648361206055 0, 86.17777252197271 23.722814559936637 0, 86.16963958740246 23.728580474853572 0, 86.16963958740246 23.728588104248104 0, 86.17825317382807 23.728149414062557 0, 86.18079376220703 23.732196807861328 0, 86.18608093261719 23.734624862671012 0, 86.18557739257818 23.74341773986822 0, 86.18838500976562 23.748241424560604 0, 86.18677520751964 23.76029777526861 0, 86.18178558349615 23.76370429992687 0, 86.18403625488281 23.768608093261832 0, 86.18157196044928 23.771181106567326 0, 86.1769790649414 23.773065567016715 0, 86.17350769042969 23.775583267211914 0, 86.17220306396484 23.77822685241705 0, 86.17287445068371 23.784120559692496 0, 86.16669464111334 23.7863826751709 0, 86.1634292602539 23.789907455444393 0, 86.16185760498047 23.79436302185053 0, 86.15991973876964 23.802789688110465 0, 86.1632308959961 23.813781738281307 0, 86.16090393066406 23.829826354980582 0, 86.15662384033209 23.829004287719727 0, 86.1502456665039 23.83115005493164 0, 86.14478302001959 23.82931709289562 0, 86.14272308349621 23.83098411560053 0, 86.14105987548822 23.83481597900402 0, 86.13602447509771 23.841714859008903 0, 86.13655090332037 23.84353256225586 0, 86.13980102539068 23.845193862914982 0, 86.1414566040039 23.848089218139762 0, 86.1379013061524 23.852275848388786 0, 86.13720703125011 23.854578018188477 0, 86.1393814086914 23.858222961425838 0, 86.1384506225586 23.86112213134777 0, 86.13275909423834 23.863256454467773 0, 86.12916564941412 23.862606048583984 0, 86.12561798095703 23.86695861816412 0, 86.12012481689453 23.867189407348633 0, 86.11862182617193 23.869293212890682 0, 86.12018585205084 23.87570762634283 0, 86.11782836914062 23.87845230102539 0, 86.11721038818354 23.88103103637701 0, 86.11987304687511 23.884338378906307 0, 86.12037658691412 23.8879909515382 0, 86.11584472656261 23.88623428344721 0, 86.11338806152355 23.886808395385856 0, 86.11244964599604 23.889200210571403 0, 86.11687469482422 23.894491195678654 0))",both
BOKARO,2061918,1076270,985648,716,"POLYGON Z ((85.91747283935558 23.956342697143555 0, 85.91757202148438 23.954755783080998 0, 85.92324829101562 23.95177078247076 0, 85.92650604248047 23.94841957092285 0, 85.92866516113287 23.943082809448356 0, 85.92913818359386 23.93578338623047 0, 85.92782592773438 23.92901420593256 0, 85.92890930175793 23.926485061645508 0, 85.93244171142578 23.926992416381893 0, 85.93863677978527 23.930030822753906 0, 85.9406509399414 23.93100547790533 0, 85.94305419921886 23.933216094970703 0, 85.94486236572271 23.933238983154354 0, 85.9480361938476 23.930259704589844 0, 85.94982910156256 23.925672531127987 0, 85.95020294189459 23.919490814208984 0, 85.95068359375011 23.911630630493164 0, 85.95161437988293 23.90781593322754 0, 85.95500946044928 23.901048660278434 0, 85.95774078369152 23.899284362793082 0, 85.96631622314464 23.898303985595703 0, 85.97525787353527 23.898784637451286 0, 85.981216430664 23.900588989257926 0, 85.98609924316412 23.902519226074332 0, 85.99645996093761 23.906925201416072 0, 85.99925994873053 23.908445358276367 0, 86.00375366210938 23.91020584106451 0, 86.0076293945313 23.91161918640148 0, 86.01576232910156 23.911853790283203 0, 86.01987457275396 23.909849166870174 0, 86.0229110717774 23.90604209899908 0, 86.02443695068365 23.902296066284293 0, 86.02645874023438 23.90046501159668 0, 86.02980804443371 23.899227142333984 0, 86.0336380004884 23.899629592895565 0, 86.04097747802734 23.902290344238338 0, 86.04918670654297 23.90408515930187 0, 86.05442047119152 23.90240478515625 0, 86.0602645874024 23.8988552093507 0, 86.0690536499024 23.895952224731445 0, 86.092514038086 23.88973999023449 0, 86.11013031005871 23.891250610351676 0, 86.1110229492188 23.893150329589957 0, 86.11687469482422 23.894491195678654 0, 86.11244964599604 23.889200210571403 0, 86.11338806152355 23.886808395385856 0, 86.11584472656261 23.88623428344721 0, 86.12037658691412 23.8879909515382 0, 86.11987304687511 23.884338378906307 0, 86.11721038818354 23.88103103637701 0, 86.11782836914062 23.87845230102539 0, 86.12018585205084 23.87570762634283 0, 86.11862182617193 23.869293212890682 0, 86.12012481689453 23.867189407348633 0, 86.12561798095703 23.86695861816412 0, 86.12916564941412 23.862606048583984 0, 86.13275909423834 23.863256454467773 0, 86.1384506225586 23.86112213134777 0, 86.1393814086914 23.858222961425838 0, 86.13720703125011 23.854578018188477 0, 86.1379013061524 23.852275848388786 0, 86.1414566040039 23.848089218139762 0, 86.13980102539068 23.845193862914982 0, 86.13655090332037 23.84353256225586 0, 86.13602447509771 23.841714859008903 0, 86.14105987548822 23.83481597900402 0, 86.14272308349621 23.83098411560053 0, 86.14478302001959 23.82931709289562 0, 86.1502456665039 23.83115005493164 0, 86.15662384033209 23.829004287719727 0, 86.16090393066406 23.829826354980582 0, 86.1632308959961 23.813781738281307 0, 86.15991973876964 23.802789688110465 0, 86.16185760498047 23.79436302185053 0, 86.1634292602539 23.789907455444393 0, 86.16669464111334 23.7863826751709 0, 86.17287445068371 23.784120559692496 0, 86.17220306396484 23.77822685241705 0, 86.17350769042969 23.775583267211914 0, 86.1769790649414 23.773065567016715 0, 86.18157196044928 23.771181106567326 0, 86.18403625488281 23.768608093261832 0, 86.18178558349615 23.76370429992687 0, 86.18677520751964 23.76029777526861 0, 86.18838500976562 23.748241424560604 0, 86.18557739257818 23.74341773986822 0, 86.18608093261719 23.734624862671012 0, 86.18079376220703 23.732196807861328 0, 86.17825317382807 23.728149414062557 0, 86.16963958740246 23.728588104248104 0, 86.16963958740246 23.728580474853572 0, 86.17777252197271 23.722814559936637 0, 86.18543243408209 23.719648361206055 0, 86.19568634033209 23.71637535095215 0, 86.20232391357422 23.712787628173885 0, 86.20644378662121 23.71143913269043 0, 86.21167755126953 23.709457397460994 0, 86.22225952148449 23.707998275756836 0, 86.23128509521484 23.707433700561523 0, 86.24161529541016 23.70743942260748 0, 86.2564697265625 23.708461761474723 0, 86.2605819702149 23.706449508666992 0, 86.27344512939453 23.707489013671875 0, 86.29722595214855 23.704484939575195 0, 86.30581665039074 23.704221725463924 0, 86.31065368652344 23.704759597778434 0, 86.35454559326172 23.702230453491154 0, 86.36949920654308 23.702505111694393 0, 86.37486267089855 23.691404342651367 0, 86.37752532958996 23.684856414794922 0, 86.38052368164068 23.68038368225092 0, 86.38446807861328 23.675956726074162 0, 86.38918304443371 23.672155380249023 0, 86.39514923095703 23.668434143066463 0, 86.40122985839844 23.66587448120123 0, 86.40767669677746 23.664775848388786 0, 86.41397857666027 23.662668228149414 0, 86.4203109741211 23.659267425537053 0, 86.42440795898443 23.640844345092773 0, 86.43180084228516 23.63134002685547 0, 86.43856811523449 23.624217987060547 0, 86.44240570068371 23.622219085693473 0, 86.44309234619146 23.61913299560547 0, 86.44313812255871 23.61157608032221 0, 86.43806457519531 23.61092185974121 0, 86.43396759033214 23.61358261108404 0, 86.43080139160156 23.61280250549322 0, 86.42817687988281 23.607385635375977 0, 86.4217147827149 23.605888366699276 0, 86.4170913696289 23.603799819946346 0, 86.41389465332037 23.60050392150879 0, 86.40975189208996 23.590469360351676 0, 86.40372467041016 23.59193420410162 0, 86.39295959472668 23.59125709533697 0, 86.39048767089855 23.58784675598156 0, 86.38446807861328 23.586849212646484 0, 86.38574218750011 23.581422805786133 0, 86.38530731201178 23.577999114990348 0, 86.38642120361334 23.574522018432674 0, 86.38166809082037 23.571350097656307 0, 86.3783950805664 23.57102966308605 0, 86.37660217285168 23.563848495483455 0, 86.37142944335949 23.561721801757812 0, 86.36836242675793 23.55957221984869 0, 86.36776733398443 23.553876876831055 0, 86.36514282226574 23.55218124389654 0, 86.3640365600586 23.548658370971793 0, 86.3615188598634 23.54559707641596 0, 86.364028930664 23.54101943969721 0, 86.36226654052746 23.536188125610295 0, 86.3632049560548 23.533222198486328 0, 86.36736297607428 23.530626296997184 0, 86.36848449707037 23.528051376342887 0, 86.37116241455084 23.525127410888786 0, 86.37054443359375 23.521423339843864 0, 86.36856842041027 23.518016815185604 0, 86.36043548583984 23.5154647827149 0, 86.36057281494152 23.512834548950252 0, 86.35724639892584 23.499019622802848 0, 86.36211395263666 23.49219131469721 0, 86.36556243896484 23.49449729919445 0, 86.37411499023449 23.492879867553768 0, 86.37564849853527 23.48870086669922 0, 86.37547302246088 23.485288619995174 0, 86.37402343750006 23.48427009582531 0, 86.37202453613293 23.486576080322322 0, 86.36791992187506 23.484785079955998 0, 86.35902404785168 23.4841823577882 0, 86.3525009155274 23.475128173828125 0, 86.35575866699224 23.470825195312557 0, 86.35536956787115 23.466268539428825 0, 86.350570678711 23.463806152343864 0, 86.34143066406256 23.463733673095817 0, 86.3418655395509 23.459623336791935 0, 86.3439407348634 23.45504760742199 0, 86.33489227294922 23.449897766113395 0, 86.33281707763678 23.45088768005371 0, 86.33217620849604 23.457622528076286 0, 86.32975769042969 23.46020698547369 0, 86.32476806640625 23.457122802734432 0, 86.31867980957031 23.45531463623047 0, 86.31564331054688 23.451244354248047 0, 86.31002044677746 23.450853347778377 0, 86.30370330810558 23.446369171142692 0, 86.3039016723634 23.443296432495174 0, 86.309326171875 23.4388484954834 0, 86.31354522705078 23.440277099609375 0, 86.31582641601562 23.439973831176815 0, 86.31640625 23.434097290039006 0, 86.31777191162115 23.430953979492244 0, 86.31687164306652 23.42874145507824 0, 86.30355072021496 23.42274093627941 0, 86.29322814941418 23.425548553466854 0, 86.2859573364259 23.430130004882812 0, 86.28472900390625 23.438104629516715 0, 86.2842483520509 23.442253112793082 0, 86.28205108642578 23.443761825561637 0, 86.27706909179688 23.44159698486328 0, 86.27079010009766 23.442638397216797 0, 86.2698822021485 23.440603256225586 0, 86.267333984375 23.439208984375114 0, 86.26143646240234 23.440866470336914 0, 86.25604248046886 23.440132141113338 0, 86.25366210937506 23.4382266998291 0, 86.25025177001959 23.43679237365734 0, 86.25154876708984 23.433485031127873 0, 86.25663757324213 23.427511215210018 0, 86.25444030761724 23.424875259399414 0, 86.2500610351563 23.421854019165096 0, 86.24678802490234 23.422241210937614 0, 86.24349975585938 23.425233840942383 0, 86.24269866943371 23.428361892700252 0, 86.2431640625 23.43431854248047 0, 86.23473358154297 23.432157516479435 0, 86.22828674316406 23.43830680847168 0, 86.22865295410156 23.445444107055664 0, 86.23097991943365 23.45221519470215 0, 86.23881530761724 23.45859336853033 0, 86.24237060546875 23.472276687622184 0, 86.23590850830078 23.473304748535213 0, 86.22896575927746 23.47246551513672 0, 86.22684478759777 23.467391967773494 0, 86.22770690917969 23.45985221862793 0, 86.22460174560541 23.458581924438477 0, 86.2133560180664 23.461822509765625 0, 86.20692443847656 23.461263656616268 0, 86.20323181152338 23.46662521362299 0, 86.19902801513683 23.466049194335994 0, 86.1954574584961 23.466987609863338 0, 86.19045257568354 23.470937728881836 0, 86.18469238281261 23.469484329223633 0, 86.1824722290039 23.470291137695426 0, 86.1828384399414 23.477678298950195 0, 86.17603302001959 23.4810791015625 0, 86.1716079711914 23.478639602661133 0, 86.15666961669933 23.47952461242687 0, 86.14924621582043 23.475610733032227 0, 86.1464004516601 23.47986030578619 0, 86.14702606201172 23.48378753662115 0, 86.1495819091798 23.488645553588867 0, 86.1489028930664 23.49650382995611 0, 86.15882873535156 23.506734848022404 0, 86.15700531005865 23.512239456176815 0, 86.15827941894531 23.52161979675293 0, 86.14665985107428 23.529802322387752 0, 86.1480331420899 23.537687301635742 0, 86.15345001220697 23.543628692627067 0, 86.15647125244152 23.55068778991705 0, 86.15702056884777 23.554023742675895 0, 86.1522064208985 23.55793380737316 0, 86.15003204345703 23.561079025268498 0, 86.15216064453125 23.566335678100643 0, 86.15193939208984 23.567832946777344 0, 86.14852142333984 23.57017707824707 0, 86.14237213134777 23.572414398193416 0, 86.13982391357428 23.571664810180607 0, 86.13550567626964 23.568630218505973 0, 86.13044738769537 23.569145202636662 0, 86.12320709228521 23.576295852661133 0, 86.11399841308594 23.573108673095703 0, 86.108642578125 23.574338912963924 0, 86.10534667968761 23.5762615203858 0, 86.10214996337885 23.573333740234318 0, 86.09736633300793 23.57238388061529 0, 86.09176635742193 23.570009231567383 0, 86.0864944458009 23.570943832397518 0, 86.07659149169916 23.57059097290039 0, 86.0752410888673 23.58083534240717 0, 86.0691375732423 23.583080291748104 0, 86.05516815185558 23.581239700317383 0, 86.05070495605469 23.586202621460018 0, 86.0412216186524 23.585792541503906 0, 86.0391998291015 23.577434539794865 0, 86.03395080566412 23.577102661132926 0, 86.02898406982428 23.57463645935053 0, 86.021484375 23.565963745117188 0, 86.01486206054693 23.563585281372127 0, 86.01461791992188 23.554012298583984 0, 86.02494812011719 23.54786300659191 0, 86.02241516113276 23.544805526733455 0, 86.02890014648432 23.534151077270508 0, 86.03088378906256 23.52665519714361 0, 86.035400390625 23.523386001587028 0, 86.03652954101557 23.52044486999523 0, 86.03659057617188 23.507280349731502 0, 86.05241394042969 23.505064010620117 0, 86.05467224121094 23.504009246826115 0, 86.05531311035162 23.501459121704215 0, 86.05104064941406 23.4960994720459 0, 86.04519653320318 23.492710113525504 0, 86.03958129882807 23.492774963378963 0, 86.03290557861322 23.489625930786246 0, 86.02943420410168 23.490537643432617 0, 86.0241928100586 23.490371704101506 0, 86.01929473876959 23.487617492675838 0, 86.01406860351562 23.48561668395996 0, 86.00942230224621 23.485149383544922 0, 86.00521850585949 23.48126220703125 0, 85.99859619140625 23.477989196777344 0, 85.9942398071289 23.47883987426752 0, 85.97952270507812 23.473192214965877 0, 85.97167968749994 23.467830657958984 0, 85.96105194091797 23.464395523071346 0, 85.95678710937511 23.462093353271484 0, 85.9536743164063 23.45791625976574 0, 85.94779205322277 23.457092285156307 0, 85.94184112548834 23.45760536193842 0, 85.92144012451178 23.464790344238395 0, 85.9166259765625 23.46973228454584 0, 85.91029357910156 23.474168777465934 0, 85.89519500732416 23.47839736938488 0, 85.88153076171875 23.47825813293457 0, 85.88701629638672 23.483247756958065 0, 85.88711547851568 23.48521804809576 0, 85.88304138183594 23.48667335510254 0, 85.88443756103521 23.48895072937023 0, 85.88353729248058 23.49026298522955 0, 85.88158416748053 23.490745544433537 0, 85.88079071044928 23.492691040039062 0, 85.87615203857422 23.49493026733404 0, 85.87525939941412 23.49758529663086 0, 85.8678588867188 23.499061584472713 0, 85.86756896972656 23.50098609924322 0, 85.86544799804682 23.50350952148449 0, 85.8615112304688 23.50473976135254 0, 85.85869598388678 23.504756927490348 0, 85.85420989990234 23.502040863037166 0, 85.85084533691412 23.500762939453182 0, 85.846435546875 23.500579833984432 0, 85.84015655517584 23.50157737731928 0, 85.83717346191418 23.5040740966798 0, 85.83651733398438 23.507251739501896 0, 85.83723449707031 23.511184692382812 0, 85.84060668945324 23.51831436157221 0, 85.83944702148449 23.521554946899414 0, 85.8330307006836 23.524894714355412 0, 85.82889556884771 23.525413513183707 0, 85.82142639160156 23.535808563232536 0, 85.8245239257813 23.539350509643498 0, 85.8360824584961 23.542755126953182 0, 85.83815002441418 23.549592971801758 0, 85.84058380126959 23.550056457519645 0, 85.83886718750006 23.554290771484375 0, 85.83291625976568 23.562234878540096 0, 85.82428741455078 23.561565399170036 0, 85.82114410400402 23.563549041748047 0, 85.81720733642578 23.562782287597713 0, 85.81332397460949 23.563230514526367 0, 85.80867004394531 23.5806827545166 0, 85.80779266357433 23.590017318725643 0, 85.80456542968761 23.594087600708065 0, 85.80200958251959 23.60017395019537 0, 85.79843139648443 23.60216140747076 0, 85.79613494873053 23.60769844055187 0, 85.79537963867193 23.608198165893498 0, 85.79100799560558 23.606048583984432 0, 85.79213714599615 23.61361122131359 0, 85.78723907470697 23.61545562744152 0, 85.79132843017584 23.622024536132812 0, 85.7835083007813 23.62703323364252 0, 85.7821655273438 23.631433486938477 0, 85.7798919677735 23.633747100830078 0, 85.7726669311524 23.63578605651861 0, 85.76968383789074 23.640428543090877 0, 85.77168273925787 23.657255172729492 0, 85.77128601074219 23.660774230957088 0, 85.76904296875006 23.666604995727653 0, 85.76593017578125 23.67164611816412 0, 85.7620849609375 23.6739444732666 0, 85.7588882446289 23.673450469970703 0, 85.75624084472662 23.667482376098633 0, 85.75376129150396 23.656036376953182 0, 85.74974822998053 23.648159027099723 0, 85.73889160156256 23.640659332275447 0, 85.73451995849615 23.639690399169922 0, 85.72981262207043 23.640357971191406 0, 85.72620391845697 23.63801383972168 0, 85.7216033935548 23.626821517944393 0, 85.71701812744152 23.620458602905273 0, 85.71215057373047 23.61827278137207 0, 85.70938873291027 23.618700027465877 0, 85.70294952392578 23.623804092407227 0, 85.70063781738293 23.62905311584484 0, 85.69792938232433 23.62994956970209 0, 85.69032287597668 23.625976562499943 0, 85.68545532226562 23.629613876342773 0, 85.68192291259777 23.631999969482365 0, 85.67823791503912 23.630773544311523 0, 85.6770858764649 23.627338409423885 0, 85.67794036865246 23.62391853332531 0, 85.67682647705078 23.621135711669922 0, 85.67201232910168 23.62034034729004 0, 85.66897583007824 23.61778640747076 0, 85.66967773437506 23.615530014038143 0, 85.6675643920899 23.613767623901367 0, 85.66411590576178 23.614191055297965 0, 85.66263580322277 23.61151885986328 0, 85.66399383544933 23.608398437500114 0, 85.6640090942384 23.60559844970703 0, 85.66167449951178 23.601381301879996 0, 85.6531448364259 23.591379165649414 0, 85.64642333984386 23.592903137207088 0, 85.64327239990234 23.595159530639705 0, 85.6358413696289 23.598239898681584 0, 85.63224792480474 23.600545883178825 0, 85.63001251220709 23.60491752624523 0, 85.62453460693371 23.612003326416016 0, 85.6208114624024 23.61476325988781 0, 85.61729431152338 23.616016387939453 0, 85.61389923095703 23.61627960205078 0, 85.61289215087902 23.6227703094483 0, 85.6144409179687 23.658105850219727 0, 85.61370849609375 23.66753578186041 0, 85.61625671386724 23.67038726806652 0, 85.61620330810547 23.67495727539074 0, 85.60856628417969 23.684181213378906 0, 85.60842132568365 23.68694877624523 0, 85.61600494384766 23.69340324401867 0, 85.61810302734375 23.69635581970215 0, 85.61956787109386 23.706212997436637 0, 85.61990356445318 23.71625518798828 0, 85.61870574951178 23.72740173339855 0, 85.61438751220714 23.73217582702631 0, 85.61445617675781 23.749832153320312 0, 85.62790679931646 23.754468917846793 0, 85.63063812255871 23.75764656066889 0, 85.63198852539057 23.760782241821346 0, 85.63603973388672 23.7642879486084 0, 85.63994598388683 23.7690486907959 0, 85.64745330810547 23.773641586303768 0, 85.64881896972656 23.781568527221623 0, 85.64853668212902 23.790990829467773 0, 85.65281677246094 23.79693984985363 0, 85.6514129638673 23.805391311645508 0, 85.64900207519531 23.80663681030279 0, 85.64417266845714 23.805526733398438 0, 85.63913726806646 23.80555343627924 0, 85.63514709472662 23.789907455444393 0, 85.63259887695312 23.787149429321403 0, 85.62458038330078 23.783607482910213 0, 85.6194686889649 23.779685974121207 0, 85.61569976806646 23.77918624877941 0, 85.61058807373058 23.78082466125494 0, 85.60806274414068 23.788320541381836 0, 85.60634613037115 23.789825439453068 0, 85.60287475585943 23.7909393310548 0, 85.60150909423828 23.794460296630973 0, 85.59816741943371 23.79632568359375 0, 85.59515380859386 23.800432205200195 0, 85.59273529052734 23.80873298645031 0, 85.5969467163086 23.81512641906744 0, 85.59609222412121 23.81847381591797 0, 85.59049224853521 23.828874588012752 0, 85.59008026123047 23.83212661743164 0, 85.58110809326172 23.8356609344483 0, 85.58393859863281 23.841434478759766 0, 85.58734893798822 23.84516143798828 0, 85.59148406982428 23.84724617004406 0, 85.61280822753912 23.854518890380916 0, 85.61511993408209 23.856224060058594 0, 85.61637878417969 23.862007141113338 0, 85.61300659179693 23.870025634765682 0, 85.6107025146485 23.873569488525447 0, 85.61069488525396 23.87887573242199 0, 85.61287689208996 23.88768768310547 0, 85.62060546875 23.894762039184684 0, 85.63230133056646 23.902637481689396 0, 85.63744354248053 23.905618667602653 0, 85.6471786499024 23.909358978271484 0, 85.64972686767572 23.91325759887701 0, 85.65680694580078 23.91654396057129 0, 85.65957641601568 23.918678283691463 0, 85.65809631347668 23.9205837249757 0, 85.65491485595703 23.922521591186467 0, 85.65468597412104 23.926883697509766 0, 85.64758300781261 23.93013000488287 0, 85.64502716064459 23.932594299316463 0, 85.64472961425793 23.936679840087947 0, 85.6473846435548 23.940921783447322 0, 85.65920257568371 23.93998527526861 0, 85.66456604003918 23.941303253173885 0, 85.66958618164062 23.943569183349666 0, 85.67240142822277 23.951929092407283 0, 85.67027282714855 23.95530509948742 0, 85.6664505004884 23.958326339721737 0, 85.6671371459961 23.95912933349615 0, 85.6742553710938 23.960054397583008 0, 85.67545318603527 23.966693878173942 0, 85.67707061767584 23.969087600708065 0, 85.67961883544933 23.96644783020031 0, 85.6826629638673 23.965904235839844 0, 85.68942260742188 23.967086791992188 0, 85.69730377197271 23.963359832763672 0, 85.69935607910156 23.961395263671932 0, 85.69825744628912 23.957487106323242 0, 85.69306945800781 23.95818519592291 0, 85.6897964477539 23.95640373229986 0, 85.68544006347656 23.949569702148494 0, 85.686264038086 23.944549560546875 0, 85.7023162841798 23.92202949523937 0, 85.70996856689464 23.916242599487248 0, 85.7157135009765 23.916896820068473 0, 85.71715545654303 23.912107467651367 0, 85.7177124023438 23.906124114990234 0, 85.72127532958984 23.904510498046875 0, 85.72281646728516 23.90839576721197 0, 85.72309875488293 23.912265777587947 0, 85.72547912597656 23.915884017944336 0, 85.73212432861322 23.922639846801758 0, 85.74203491210932 23.92713356018072 0, 85.74029541015636 23.930629730224723 0, 85.74198150634777 23.933490753173942 0, 85.7451400756836 23.934427261352653 0, 85.74758911132812 23.930948257446346 0, 85.75090026855474 23.929098129272518 0, 85.76546478271496 23.927093505859432 0, 85.76770782470709 23.924247741699332 0, 85.76546478271496 23.910844802856445 0, 85.77013397216797 23.905487060546932 0, 85.77701568603521 23.900999069213867 0, 85.78437805175776 23.900873184204045 0, 85.78459167480469 23.89743232727062 0, 85.78661346435558 23.886844635009766 0, 85.78998565673834 23.884023666381836 0, 85.79983520507807 23.881908416748047 0, 85.8015518188476 23.87975883483898 0, 85.79866027832043 23.874366760253906 0, 85.79962158203136 23.87110137939453 0, 85.80203247070318 23.869108200073356 0, 85.80362701416027 23.86646842956543 0, 85.80294036865234 23.864110946655387 0, 85.80414581298834 23.861675262451172 0, 85.8072662353515 23.860004425048885 0, 85.8055572509765 23.857200622558594 0, 85.80546569824224 23.84683990478527 0, 85.81356811523432 23.842144012451286 0, 85.81559753417974 23.839302062988338 0, 85.81446838378918 23.8342342376709 0, 85.82858276367199 23.832372665405273 0, 85.83180236816412 23.83262443542486 0, 85.83629608154297 23.830080032348746 0, 85.84147644042969 23.83737373352045 0, 85.84552764892584 23.840854644775334 0, 85.86190795898443 23.85087203979498 0, 85.86444091796886 23.854610443115234 0, 85.8648147583009 23.85801124572754 0, 85.86625671386719 23.86170387268072 0, 85.86592102050787 23.866271972656364 0, 85.8681640625 23.869300842285213 0, 85.86976623535162 23.873195648193416 0, 85.87234497070312 23.877725601196346 0, 85.87882995605469 23.886156082153434 0, 85.88186645507812 23.89219665527355 0, 85.88628387451172 23.896478652954215 0, 85.88837432861328 23.901813507080135 0, 85.88814544677729 23.90709877014166 0, 85.88901519775396 23.911994934082088 0, 85.88418579101562 23.914329528808707 0, 85.8833999633789 23.91757202148449 0, 85.88375854492182 23.92112922668457 0, 85.88605499267578 23.926881790161133 0, 85.88638305664074 23.93134117126465 0, 85.88520812988287 23.936134338378906 0, 85.88323211669922 23.93875503540039 0, 85.88228607177734 23.941974639892578 0, 85.88545989990246 23.949962615966797 0, 85.88793182373058 23.953704833984375 0, 85.89132690429699 23.954980850219783 0, 85.89538574218744 23.952964782714844 0, 85.89843749999994 23.954175949096793 0, 85.9013061523437 23.9533367156983 0, 85.90532684326172 23.949237823486328 0, 85.91220092773438 23.945892333984375 0, 85.9114761352539 23.95404624938965 0, 85.91299438476562 23.95585823059082 0, 85.91747283935558 23.956342697143555 0))",both
LOHARDAGA,461738,232575,229163,310,"POLYGON Z ((84.39695739746105 23.6047306060791 0, 84.3983383178711 23.609708786010856 0, 84.39514923095709 23.615442276001033 0, 84.39542388916027 23.622665405273494 0, 84.39354705810541 23.63383102416998 0, 84.39385223388678 23.63817214965826 0, 84.41017150878906 23.640541076660156 0, 84.41332244873058 23.636779785156307 0, 84.41851806640636 23.634046554565487 0, 84.4329452514649 23.632665634155273 0, 84.43678283691418 23.634269714355526 0, 84.44004058837902 23.637287139892692 0, 84.44390869140625 23.636119842529354 0, 84.45029449462896 23.632553100585994 0, 84.45537567138672 23.628576278686637 0, 84.46121215820324 23.628215789794922 0, 84.46112060546875 23.631597518920955 0, 84.45893859863293 23.636384963989258 0, 84.45862579345703 23.642080307006893 0, 84.4604110717774 23.647624969482365 0, 84.4680633544923 23.65765953063965 0, 84.47366333007812 23.66209220886236 0, 84.47935485839855 23.66382217407238 0, 84.48842620849615 23.663923263549805 0, 84.49452209472662 23.67395401000971 0, 84.50318908691418 23.67665863037115 0, 84.50710296630865 23.676280975341797 0, 84.52547454833996 23.668767929077205 0, 84.52827453613287 23.668214797973633 0, 84.53409576416027 23.669942855835075 0, 84.53642272949219 23.668485641479492 0, 84.54563140869146 23.651330947876033 0, 84.55293273925787 23.642791748046875 0, 84.552993774414 23.63788223266613 0, 84.55088043212902 23.6317195892334 0, 84.55184936523432 23.62907028198248 0, 84.56357574462896 23.614921569824162 0, 84.57703399658197 23.616056442260742 0, 84.58130645751959 23.617321014404297 0, 84.5823440551759 23.620037078857422 0, 84.58488464355469 23.641719818115178 0, 84.58908081054688 23.655059814453182 0, 84.58834075927734 23.665773391723633 0, 84.59956359863281 23.668375015258732 0, 84.60785675048834 23.660062789917106 0, 84.61116027832043 23.658727645874137 0, 84.61389923095703 23.6591854095459 0, 84.61802673339855 23.661804199218864 0, 84.62181854248058 23.661823272705135 0, 84.63563537597656 23.66522407531744 0, 84.639144897461 23.667888641357422 0, 84.64208221435547 23.66660308837885 0, 84.64649963378906 23.66109275817871 0, 84.65296173095703 23.654977798462028 0, 84.65707397460943 23.64817237854004 0, 84.65901184082043 23.64174652099615 0, 84.66031646728521 23.629844665527344 0, 84.66191101074213 23.62629699707037 0, 84.67252349853521 23.62177467346197 0, 84.6771621704101 23.617733001708984 0, 84.67866516113293 23.604593276977596 0, 84.68202209472662 23.60482978820812 0, 84.68703460693371 23.606664657592717 0, 84.69289398193365 23.610071182250977 0, 84.69978332519537 23.61162757873541 0, 84.71308135986328 23.6169891357423 0, 84.71834564208996 23.618305206298828 0, 84.72235107421886 23.621540069580078 0, 84.72412109375 23.62465095520031 0, 84.7245101928711 23.635206222534237 0, 84.725830078125 23.638875961303825 0, 84.7294311523437 23.640247344970703 0, 84.73348236083984 23.638860702514762 0, 84.73618316650396 23.63626861572277 0, 84.73732757568365 23.632722854614258 0, 84.7401351928711 23.63165855407709 0, 84.74179840087902 23.627206802368164 0, 84.74302673339844 23.610397338867188 0, 84.74552917480474 23.608379364013672 0, 84.7506942749024 23.607440948486328 0, 84.75624084472662 23.60543251037592 0, 84.76100158691412 23.6009902954101 0, 84.76406097412115 23.59394645690918 0, 84.76389312744152 23.585649490356445 0, 84.76553344726562 23.583179473876953 0, 84.77083587646484 23.580659866333008 0, 84.77170562744146 23.57501792907709 0, 84.77420043945324 23.57344436645502 0, 84.78303527832031 23.571901321411133 0, 84.78271484375006 23.566196441650334 0, 84.77923583984375 23.554674148559684 0, 84.7807083129884 23.549489974975586 0, 84.78304290771484 23.5460586547851 0, 84.7882080078125 23.5450057983399 0, 84.79074096679693 23.54552078247076 0, 84.79121398925793 23.55528450012207 0, 84.79265594482428 23.56093406677246 0, 84.79161071777338 23.56499481201172 0, 84.792236328125 23.571367263794002 0, 84.79293823242182 23.575662612915153 0, 84.79577636718761 23.577869415283203 0, 84.79901123046886 23.57703399658203 0, 84.79812622070312 23.56625747680664 0, 84.80090332031261 23.562936782836914 0, 84.80537414550781 23.56312179565441 0, 84.81538391113287 23.569190979003906 0, 84.81862640380865 23.56891059875494 0, 84.8205184936524 23.565477371215877 0, 84.81875610351562 23.54825782775879 0, 84.81977844238293 23.5443172454834 0, 84.85166168212902 23.533678054809684 0, 84.85475158691406 23.53605079650879 0, 84.85831451416027 23.542264938354492 0, 84.86428070068354 23.541259765625114 0, 84.86680603027344 23.544086456298828 0, 84.87077331542969 23.5450057983399 0, 84.87458038330072 23.558151245117188 0, 84.88420867919928 23.558069229126033 0, 84.88351440429699 23.552371978759822 0, 84.88737487792969 23.55029296875 0, 84.89231109619135 23.543670654296932 0, 84.9060440063476 23.540857315063533 0, 84.9083480834961 23.538501739502067 0, 84.91407775878906 23.52697181701666 0, 84.92431640625011 23.52587509155279 0, 84.93668365478521 23.519243240356445 0, 84.9378280639649 23.510047912597656 0, 84.94203186035162 23.50469970703125 0, 84.9431838989259 23.501085281372184 0, 84.93986511230469 23.490354537963867 0, 84.93372344970703 23.482387542724666 0, 84.93023681640636 23.47560119628912 0, 84.92797088623058 23.473112106323356 0, 84.92449951171886 23.47191619873047 0, 84.91993713378918 23.461753845214787 0, 84.90860748291021 23.452123641967887 0, 84.90341186523438 23.4434814453125 0, 84.8980712890625 23.436584472656193 0, 84.89466094970703 23.430137634277344 0, 84.89407348632812 23.426353454589844 0, 84.8950805664063 23.42376518249506 0, 84.89525604248053 23.418575286865234 0, 84.89663696289068 23.416090011596793 0, 84.89321899414074 23.411172866821346 0, 84.88859558105474 23.407548904419002 0, 84.88446044921886 23.405904769897518 0, 84.8841781616211 23.402687072753906 0, 84.88771057128918 23.397222518921012 0, 84.89263916015636 23.386619567871037 0, 84.88227844238287 23.37614059448248 0, 84.88348388671886 23.373043060302734 0, 84.88568878173828 23.3709011077882 0, 84.88947296142578 23.370349884033203 0, 84.90235137939459 23.364799499511776 0, 84.90302276611328 23.354297637939453 0, 84.90510559082031 23.343463897705078 0, 84.89589691162121 23.32063102722168 0, 84.8888626098634 23.317680358886776 0, 84.88212585449224 23.31663894653326 0, 84.87258148193365 23.31153106689453 0, 84.86717987060547 23.314838409423828 0, 84.86227416992193 23.31669044494629 0, 84.84976959228527 23.316490173339844 0, 84.84637451171875 23.31423187255865 0, 84.84378814697271 23.31112098693842 0, 84.84290313720714 23.30548286437994 0, 84.84039306640636 23.301532745361385 0, 84.8365097045899 23.297912597656193 0, 84.8257293701173 23.296077728271598 0, 84.818588256836 23.295831680297965 0, 84.81549835205078 23.29485702514654 0, 84.81408691406261 23.293500900268555 0, 84.81222534179688 23.286390304565543 0, 84.81082916259777 23.284011840820312 0, 84.8025512695313 23.281896591186523 0, 84.79010009765625 23.280441284179688 0, 84.78699493408214 23.280544281005916 0, 84.78543853759771 23.28183364868164 0, 84.78473663330072 23.28375434875494 0, 84.78652954101568 23.297075271606445 0, 84.79071044921875 23.312719345092887 0, 84.7901382446289 23.315143585205192 0, 84.78620147705084 23.317720413208065 0, 84.7851791381836 23.3217830657959 0, 84.77837371826178 23.32028388977045 0, 84.76931762695312 23.320081710815487 0, 84.7520141601563 23.322052001953182 0, 84.74826812744152 23.32456970214855 0, 84.74367523193371 23.331892013549805 0, 84.73381042480463 23.332244873046818 0, 84.7142105102539 23.32122039794922 0, 84.70934295654308 23.31244659423828 0, 84.703598022461 23.311185836792106 0, 84.69635772705084 23.310134887695256 0, 84.6904754638673 23.31022071838379 0, 84.6861572265625 23.313592910766715 0, 84.68313598632812 23.3178653717041 0, 84.6792984008789 23.31785011291504 0, 84.6761093139649 23.320484161377067 0, 84.67276000976574 23.32063484191906 0, 84.66914367675793 23.316839218139705 0, 84.66226196289074 23.316184997558707 0, 84.65719604492188 23.30996513366705 0, 84.64905548095709 23.31257438659668 0, 84.64276885986334 23.308759689331055 0, 84.63379669189459 23.307874679565487 0, 84.62671661376959 23.309535980224666 0, 84.62064361572271 23.315027236938533 0, 84.61661529541021 23.319868087768555 0, 84.61325073242199 23.321933746337947 0, 84.60598754882824 23.317386627197322 0, 84.59436798095714 23.320146560668945 0, 84.5877685546875 23.32254219055187 0, 84.57655334472662 23.33269691467285 0, 84.57099914550787 23.342599868774357 0, 84.56474304199224 23.34702491760254 0, 84.56002044677746 23.348743438720646 0, 84.55530548095703 23.348545074463004 0, 84.55085754394543 23.347055435180664 0, 84.5431747436524 23.346057891845817 0, 84.53639221191418 23.34900856018072 0, 84.52416229248058 23.36632347106945 0, 84.5185317993164 23.370347976684627 0, 84.51955413818365 23.378824234008903 0, 84.51782989501959 23.38236236572277 0, 84.51123809814453 23.384578704834098 0, 84.50315093994146 23.37624740600586 0, 84.50046539306646 23.37233161926281 0, 84.49927520751953 23.36780929565441 0, 84.49930572509771 23.355680465698242 0, 84.49797821044928 23.352966308593807 0, 84.49069976806646 23.354393005371094 0, 84.48447418212902 23.35672569274908 0, 84.47741699218761 23.36068916320812 0, 84.47315216064459 23.365520477295036 0, 84.47079467773432 23.370521545410213 0, 84.47160339355469 23.37492942810053 0, 84.47132873535168 23.387735366821346 0, 84.47522735595703 23.392608642578182 0, 84.47898864746088 23.39540290832531 0, 84.47341918945324 23.404058456421012 0, 84.46139526367199 23.4084415435791 0, 84.44979095458996 23.403461456298942 0, 84.44495391845709 23.40388107299799 0, 84.4417114257813 23.40555381774908 0, 84.43191528320312 23.41492080688488 0, 84.42195892333979 23.426929473877067 0, 84.42316436767578 23.430042266845703 0, 84.42598724365234 23.432880401611328 0, 84.4402847290039 23.445039749145508 0, 84.44609069824224 23.456476211547795 0, 84.45034790039074 23.45892333984375 0, 84.45531463623058 23.463356018066406 0, 84.4592056274414 23.465299606323356 0, 84.46201324462885 23.468303680420036 0, 84.46685028076172 23.478494644165096 0, 84.47272491455078 23.48574829101574 0, 84.47338104248053 23.488180160522575 0, 84.46791839599621 23.498703002929744 0, 84.46752166748058 23.50558090209961 0, 84.46870422363281 23.514898300171012 0, 84.46756744384766 23.521381378173828 0, 84.46068572998041 23.530757904052734 0, 84.4600219726563 23.53465652465826 0, 84.46052551269531 23.539566040039176 0, 84.46833038330078 23.570363998413143 0, 84.46893310546875 23.576517105102596 0, 84.46628570556646 23.579662322998104 0, 84.46109771728516 23.582960128784237 0, 84.44994354248058 23.585489273071346 0, 84.45195007324219 23.593626022338924 0, 84.4511184692384 23.596107482910156 0, 84.44931793212896 23.595529556274414 0, 84.44760894775396 23.593769073486385 0, 84.44381713867193 23.59402275085455 0, 84.44020843505865 23.58920860290533 0, 84.4053421020509 23.600555419921932 0, 84.39695739746105 23.6047306060791 0))",both
PURBI SINGHBHUM,2291032,1175696,1115336,648,"POLYGON Z ((86.23793029785168 22.99665451049799 0, 86.23794555664057 22.996660232543945 0, 86.24208831787121 22.998174667358512 0, 86.24855041503912 22.998750686645508 0, 86.25431060791027 22.99827575683588 0, 86.2647323608399 22.998840332031193 0, 86.26721954345709 23.001321792602653 0, 86.26671600341808 23.002655029296818 0, 86.26845550537121 23.00369071960455 0, 86.27314758300787 23.007722854614258 0, 86.27694702148443 23.009819030761776 0, 86.27895355224604 23.01188087463379 0, 86.28279113769531 23.014003753662053 0, 86.28816986083984 23.014144897460938 0, 86.29540252685547 23.013353347778434 0, 86.29531860351574 23.012342453002873 0, 86.29742431640636 23.01140785217291 0, 86.29823303222656 23.01243400573736 0, 86.29979705810547 23.013496398925895 0, 86.30094146728516 23.01655006408697 0, 86.30166625976562 23.016565322876033 0, 86.30371093750011 23.015632629394474 0, 86.30410766601574 23.013639450073356 0, 86.30383300781256 23.011611938476676 0, 86.30359649658203 23.009601593017692 0, 86.30552673339844 23.00665473937994 0, 86.3093032836914 23.00579261779785 0, 86.31331634521484 23.003955841064453 0, 86.31328582763666 23.00144386291504 0, 86.31556701660168 22.9985294342041 0, 86.31867980957031 22.99888420104986 0, 86.32923126220709 22.995748519897404 0, 86.33551788330084 22.99223518371582 0, 86.33809661865234 22.99268531799322 0, 86.34468078613287 22.9966144561767 0, 86.349838256836 22.996356964111385 0, 86.3538436889649 22.992521286010742 0, 86.35495758056646 22.998245239257926 0, 86.36331939697266 23.00001335144043 0, 86.36657714843756 22.996099472046012 0, 86.37284088134766 22.99765014648449 0, 86.38375854492193 22.994102478027344 0, 86.38427734375 22.98777770996088 0, 86.38693237304688 22.98349952697754 0, 86.39061737060553 22.980106353759766 0, 86.3963470458985 22.977617263794002 0, 86.40018463134771 22.981201171875057 0, 86.40361785888678 22.986507415771598 0, 86.413818359375 22.990386962890682 0, 86.41956329345703 22.99815177917486 0, 86.4349746704101 22.993705749511662 0, 86.443832397461 22.993455886840877 0, 86.4449462890625 22.99071502685547 0, 86.44847869873058 22.988473892211914 0, 86.45105743408203 22.99047088623047 0, 86.45433807373053 22.99099349975586 0, 86.46634674072271 22.9886150360108 0, 86.46944427490246 22.992015838623104 0, 86.47817230224615 22.98905754089367 0, 86.48258209228521 22.992246627807674 0, 86.5005569458009 22.993309020996037 0, 86.50050354003912 22.9865665435791 0, 86.50721740722668 22.98143959045416 0, 86.51081848144537 22.97620010375988 0, 86.50312042236328 22.971971511840934 0, 86.51543426513683 22.969705581664982 0, 86.52192687988293 22.971549987793082 0, 86.52588653564459 22.975597381591854 0, 86.52394866943365 22.97625160217285 0, 86.537338256836 22.984781265258732 0, 86.543441772461 22.990652084350586 0, 86.54520416259777 22.97777366638195 0, 86.54090118408203 22.96928024291998 0, 86.54166412353516 22.965322494506893 0, 86.53562164306646 22.965681076049805 0, 86.52980041503906 22.96431541442871 0, 86.53072357177729 22.961385726928825 0, 86.52656555175781 22.9521484375 0, 86.5215530395509 22.947803497314567 0, 86.51591491699219 22.949665069580135 0, 86.5107650756836 22.948823928833065 0, 86.50188446044933 22.951206207275504 0, 86.49982452392572 22.950998306274528 0, 86.50093841552746 22.94859886169445 0, 86.4989624023438 22.944759368896598 0, 86.4972152709961 22.94495773315424 0, 86.49565887451172 22.94769477844244 0, 86.49262237548828 22.947526931762752 0, 86.48999786376959 22.939010620117188 0, 86.48772430419928 22.937759399414176 0, 86.48702239990246 22.94172286987299 0, 86.48192596435547 22.944055557251033 0, 86.47669219970714 22.947536468505916 0, 86.47758483886724 22.952281951904297 0, 86.47364807128918 22.952903747558594 0, 86.47332763671875 22.950067520141545 0, 86.46529388427746 22.9476776123048 0, 86.4612503051759 22.942251205444393 0, 86.46142578125006 22.93643188476574 0, 86.45426940917969 22.933942794799748 0, 86.4403305053711 22.93075752258312 0, 86.43606567382824 22.926876068115234 0, 86.4343948364259 22.923616409301758 0, 86.43566894531256 22.919258117675895 0, 86.4517059326173 22.90543174743658 0, 86.46557617187506 22.902509689331055 0, 86.46625518798822 22.900157928466797 0, 86.45423126220714 22.886518478393555 0, 86.45018005371105 22.886960983276424 0, 86.45249938964855 22.880609512329215 0, 86.44985961914057 22.873012542724723 0, 86.45090484619146 22.86530876159668 0, 86.4500961303711 22.862356185913143 0, 86.43605804443365 22.86406707763672 0, 86.4345092773438 22.8499698638916 0, 86.43643951416021 22.84419441223156 0, 86.4362411499024 22.838939666748047 0, 86.4371337890625 22.83221435546875 0, 86.42481994628918 22.81246566772461 0, 86.4211883544923 22.793491363525504 0, 86.41586303710949 22.790111541748047 0, 86.41937255859375 22.78020668029791 0, 86.42520141601574 22.777898788452262 0, 86.43209075927746 22.772144317627067 0, 86.44303131103516 22.766408920288143 0, 86.44709777832037 22.762327194213867 0, 86.45719146728521 22.763376235961914 0, 86.46920776367193 22.750219345092887 0, 86.46984100341808 22.744009017944336 0, 86.47319030761719 22.741184234619197 0, 86.48213958740234 22.7261905670166 0, 86.48476409912104 22.728544235229492 0, 86.49088287353516 22.72709465026861 0, 86.49306488037115 22.723619461059684 0, 86.49966430664062 22.719297409057674 0, 86.50349426269531 22.714874267578125 0, 86.5097122192384 22.705364227295036 0, 86.512680053711 22.706106185913143 0, 86.51118469238287 22.712009429931697 0, 86.51307678222662 22.71988487243658 0, 86.51955413818365 22.718614578247127 0, 86.52327728271496 22.721727371215934 0, 86.53678131103527 22.720413208007812 0, 86.54234313964855 22.724483489990178 0, 86.54940795898449 22.71913146972662 0, 86.5525970458985 22.714752197265682 0, 86.5581741333009 22.711738586425895 0, 86.57706451416027 22.69852256774908 0, 86.5838241577149 22.692882537841797 0, 86.59425354003906 22.692541122436523 0, 86.59970855712896 22.689344406127987 0, 86.60591125488281 22.68374824523937 0, 86.6131591796875 22.681337356567383 0, 86.62087249755865 22.67731475830078 0, 86.62535095214844 22.670249938964844 0, 86.63336944580078 22.666460037231445 0, 86.63965606689453 22.659082412719783 0, 86.63845825195324 22.651168823242188 0, 86.6397094726563 22.63482475280773 0, 86.63807678222668 22.626676559448185 0, 86.63535308837896 22.614009857177848 0, 86.63695526123058 22.608047485351562 0, 86.6372680664063 22.60131263732916 0, 86.64192962646479 22.597816467285213 0, 86.65122222900402 22.595672607421875 0, 86.65402221679693 22.58834457397461 0, 86.65226745605469 22.586124420166072 0, 86.6546249389649 22.579879760742244 0, 86.66020965576183 22.57680702209467 0, 86.66432952880865 22.578540802002067 0, 86.67571258544922 22.576486587524414 0, 86.6768035888673 22.577592849731445 0, 86.68629455566412 22.58086585998535 0, 86.70891571044922 22.58445930480957 0, 86.73054504394537 22.578756332397575 0, 86.75881958007824 22.57839584350586 0, 86.76276397705084 22.57655906677246 0, 86.76625823974621 22.56877517700201 0, 86.7702255249024 22.565038681030387 0, 86.76976013183594 22.560190200805778 0, 86.76630401611328 22.55667877197277 0, 86.76732635498053 22.55479431152355 0, 86.77406311035168 22.55248069763178 0, 86.774169921875 22.550010681152457 0, 86.77909851074219 22.551181793212947 0, 86.78067779541021 22.549592971801758 0, 86.78684997558605 22.548421859741325 0, 86.78895568847668 22.541601181030217 0, 86.78557586669922 22.53993034362793 0, 86.78810882568365 22.53663635253912 0, 86.78798675537121 22.533517837524414 0, 86.78560638427734 22.52857971191412 0, 86.79249572753912 22.524604797363338 0, 86.79418182373047 22.520885467529354 0, 86.79454803466797 22.517665863037223 0, 86.79206848144531 22.513885498046932 0, 86.7924194335937 22.511812210083008 0, 86.80137634277338 22.503080368041935 0, 86.79373168945324 22.497896194458008 0, 86.79571533203125 22.49486732482916 0, 86.79977416992193 22.493036270141715 0, 86.80073547363287 22.491264343261832 0, 86.80078887939464 22.488267898559684 0, 86.79832458496088 22.4839706420899 0, 86.79198455810558 22.478801727294865 0, 86.78828430175781 22.480934143066463 0, 86.78529357910162 22.481637954711914 0, 86.77848815917963 22.48158454895031 0, 86.7723236083985 22.480222702026367 0, 86.76346588134766 22.483190536499137 0, 86.75613403320324 22.484397888183707 0, 86.7510757446289 22.482933044433594 0, 86.74822235107422 22.479957580566463 0, 86.74794769287121 22.474822998046932 0, 86.75180053710938 22.46463584899908 0, 86.75427246093744 22.454996109008846 0, 86.7602310180664 22.450710296630916 0, 86.7598724365235 22.446788787841797 0, 86.76074218750011 22.44000816345215 0, 86.76503753662115 22.429594039917106 0, 86.76668548583984 22.42725753784191 0, 86.77203369140625 22.425954818725643 0, 86.78144836425787 22.425870895385742 0, 86.791732788086 22.42263221740734 0, 86.80798339843756 22.42087554931652 0, 86.82112121582037 22.416698455810547 0, 86.83361053466791 22.410781860351676 0, 86.84143829345697 22.405780792236328 0, 86.84661865234375 22.400503158569336 0, 86.8476181030274 22.396766662597656 0, 86.8462753295899 22.39208412170416 0, 86.84317779541016 22.38869285583496 0, 86.84092712402344 22.383069992065543 0, 86.84363555908209 22.373495101928768 0, 86.83902740478521 22.36536216735834 0, 86.83163452148443 22.34601593017578 0, 86.83274078369146 22.342922210693416 0, 86.83123016357428 22.33402442932129 0, 86.83188629150402 22.32913970947277 0, 86.8395767211914 22.321311950683707 0, 86.84333801269526 22.318374633789062 0, 86.84984588623047 22.317722320556697 0, 86.86560058593761 22.30840301513672 0, 86.87072753906256 22.30916786193859 0, 86.87385559082026 22.307262420654354 0, 86.8752212524414 22.303365707397575 0, 86.88343048095703 22.30101203918457 0, 86.88774871826183 22.301305770874023 0, 86.88884735107428 22.298727035522518 0, 86.8894729614259 22.291309356689396 0, 86.89105987548828 22.28603744506836 0, 86.89121246337885 22.280338287353572 0, 86.89058685302746 22.274223327636832 0, 86.88825225830084 22.2735538482666 0, 86.88816833496088 22.268085479736328 0, 86.88928222656261 22.26366233825695 0, 86.88829803466808 22.256795883178825 0, 86.8757705688476 22.259143829345703 0, 86.87168121337896 22.25931167602539 0, 86.86724853515625 22.258146286010856 0, 86.86099243164068 22.259094238281307 0, 86.85686492919933 22.261447906494197 0, 86.85334014892584 22.26514434814453 0, 86.85279846191412 22.26392555236822 0, 86.84392547607422 22.2617702484132 0, 86.83872985839855 22.26543617248541 0, 86.83640289306646 22.264249801635856 0, 86.83109283447277 22.263883590698356 0, 86.82549285888678 22.265979766845703 0, 86.82302856445318 22.265256881713867 0, 86.8218002319336 22.258213043212947 0, 86.8190307617188 22.25396156311041 0, 86.81652069091803 22.262672424316406 0, 86.81526184082043 22.26392936706543 0, 86.81455993652344 22.268573760986442 0, 86.81402587890625 22.264133453369197 0, 86.81190490722656 22.258462905883732 0, 86.81265258789062 22.254209518432617 0, 86.81166076660168 22.25113677978527 0, 86.8101272583009 22.250488281250057 0, 86.80929565429693 22.248456954955998 0, 86.80664062500006 22.248643875122127 0, 86.80513000488287 22.246490478515682 0, 86.80229949951183 22.245641708374023 0, 86.7996063232423 22.24772644042963 0, 86.79920196533209 22.249736785888615 0, 86.80116271972668 22.2501163482666 0, 86.79911804199219 22.254575729370117 0, 86.8033447265625 22.266565322876033 0, 86.79299163818354 22.267435073852482 0, 86.79341888427734 22.257888793945312 0, 86.7958755493164 22.248653411865234 0, 86.79554748535162 22.243406295776424 0, 86.8002700805664 22.23863983154297 0, 86.802230834961 22.23987770080572 0, 86.80408477783203 22.243310928344783 0, 86.8125610351563 22.24269104003912 0, 86.81184387207043 22.237785339355582 0, 86.80280303955084 22.218351364135742 0, 86.79408264160168 22.222248077392692 0, 86.7844467163086 22.226482391357422 0, 86.78521728515625 22.230054855346737 0, 86.79384613037115 22.22500991821289 0, 86.79489898681635 22.228540420532227 0, 86.78953552246105 22.234035491943416 0, 86.78269195556635 22.236408233642578 0, 86.77861785888678 22.236230850219783 0, 86.77548217773438 22.23503303527832 0, 86.77479553222662 22.23237228393549 0, 86.7772827148438 22.22808456420904 0, 86.77556610107428 22.22492599487316 0, 86.7692260742188 22.22447204589838 0, 86.75334930419922 22.225486755371094 0, 86.75210571289068 22.225437164306697 0, 86.74328613281256 22.22507286071783 0, 86.73522186279297 22.224584579467887 0, 86.73341369628912 22.22447586059576 0, 86.7333602905274 22.22447204589838 0, 86.72573852539068 22.22407722473156 0, 86.70833587646484 22.22639656066906 0, 86.6963958740235 22.22821998596197 0, 86.68247222900396 22.23286247253418 0, 86.67434692382807 22.24015617370611 0, 86.66672515869135 22.246622085571403 0, 86.65876770019531 22.25358390808117 0, 86.65793609619152 22.2651882171632 0, 86.65711212158209 22.269166946411133 0, 86.64478302001947 22.274744033813477 0, 86.63799285888678 22.27321624755865 0, 86.63002777099615 22.27142333984375 0, 86.6189575195313 22.280565261840934 0, 86.61141967773438 22.283321380615234 0, 86.60555267333984 22.28299331665039 0, 86.60136413574219 22.278947830200252 0, 86.59386444091791 22.279397964477653 0, 86.59285736083996 22.28669357299816 0, 86.58855438232422 22.291173934936467 0, 86.58853912353516 22.29542732238781 0, 86.58512878417969 22.295551300048828 0, 86.58424377441412 22.29944610595703 0, 86.58140563964855 22.302341461181754 0, 86.57815551757818 22.300848007202262 0, 86.57727813720703 22.2984676361084 0, 86.5736465454101 22.297481536865234 0, 86.5706634521485 22.301523208618278 0, 86.56416320800781 22.30152702331543 0, 86.5550384521485 22.299812316894474 0, 86.54872131347656 22.30344772338873 0, 86.54286956787115 22.308237075805607 0, 86.53536987304688 22.302696228027344 0, 86.52754974365234 22.307342529296932 0, 86.52619934082031 22.312330245971793 0, 86.52384185791027 22.31597328186041 0, 86.52809143066406 22.316850662231445 0, 86.52665710449224 22.323045730590877 0, 86.52260589599615 22.325046539306754 0, 86.51101684570318 22.32847785949707 0, 86.50430297851568 22.335899353027344 0, 86.50299835205084 22.34537887573248 0, 86.48676300048834 22.34883689880371 0, 86.48477172851562 22.346445083618164 0, 86.48159027099615 22.338895797729492 0, 86.47763824462896 22.338651657104606 0, 86.47148895263678 22.336706161499137 0, 86.47007751464838 22.33333969116211 0, 86.46702575683588 22.331439971923828 0, 86.46332550048834 22.330858230590877 0, 86.46131134033203 22.326551437377987 0, 86.45263671875006 22.32749748229986 0, 86.44490814208984 22.32976913452154 0, 86.44148254394531 22.327806472778377 0, 86.44188690185547 22.32090568542492 0, 86.44329071044928 22.315862655639705 0, 86.44241333007807 22.310260772705078 0, 86.43645477294933 22.306007385253963 0, 86.42750549316418 22.310726165771598 0, 86.42780303955084 22.313663482666016 0, 86.42479705810553 22.31834030151373 0, 86.4144897460938 22.319993972778377 0, 86.40444183349621 22.323843002319336 0, 86.3937454223634 22.329689025878963 0, 86.37869262695324 22.341508865356502 0, 86.366195678711 22.34398841857916 0, 86.3559188842774 22.349784851074162 0, 86.35584259033203 22.35589218139654 0, 86.35054779052734 22.363340377807617 0, 86.34252166748047 22.37038612365734 0, 86.32855987548828 22.377388000488395 0, 86.32307434082031 22.384654998779297 0, 86.32093048095703 22.394866943359432 0, 86.31303405761724 22.401523590088004 0, 86.30548858642578 22.409446716308707 0, 86.30389404296886 22.419559478759766 0, 86.29617309570312 22.42436599731451 0, 86.29122161865234 22.429571151733455 0, 86.28308105468756 22.449697494506836 0, 86.27465820312506 22.447004318237248 0, 86.26847839355469 22.443717956543026 0, 86.26286315917974 22.44544982910162 0, 86.24588012695318 22.448698043823356 0, 86.23182678222668 22.453733444213867 0, 86.22436523437511 22.454744338989258 0, 86.2237167358399 22.45323371887207 0, 86.21485137939464 22.463832855224666 0, 86.22028350830084 22.468149185180664 0, 86.22153472900402 22.472322463989258 0, 86.22092437744152 22.472368240356502 0, 86.2198715209961 22.46917343139654 0, 86.2124862670899 22.466957092285156 0, 86.20574951171875 22.47438240051264 0, 86.2000503540039 22.47185134887701 0, 86.17709350585949 22.48050880432129 0, 86.16940307617193 22.48082351684576 0, 86.15894317626964 22.483154296875 0, 86.1485595703125 22.479211807250977 0, 86.14965057373047 22.4832057952882 0, 86.12335205078125 22.489606857299805 0, 86.11534881591797 22.4869709014892 0, 86.11077880859375 22.488945007324276 0, 86.10482788085938 22.494180679321403 0, 86.10160064697266 22.499647140502873 0, 86.0969696044923 22.51221656799322 0, 86.09502410888678 22.513151168823356 0, 86.0818481445313 22.53436088562006 0, 86.07270050048834 22.547004699706974 0, 86.06534576416016 22.552410125732536 0, 86.07043457031261 22.56381416320812 0, 86.07286834716803 22.566123962402344 0, 86.07583618164062 22.568943023681697 0, 86.10037994384777 22.584545135498047 0, 86.10381317138683 22.588909149169922 0, 86.10628509521496 22.59204864501953 0, 86.11250305175781 22.597604751586914 0, 86.11727905273438 22.606441497802734 0, 86.1364212036134 22.618755340576286 0, 86.14298248291016 22.625402450561523 0, 86.14756774902344 22.632036209106502 0, 86.15486145019537 22.637269973754826 0, 86.15550994873058 22.651067733764762 0, 86.15798187255871 22.654314041137752 0, 86.16718292236322 22.67114448547369 0, 86.16240692138683 22.677328109741268 0, 86.1619720458985 22.699470520019588 0, 86.16055297851562 22.717954635620174 0, 86.16389465332043 22.725652694702262 0, 86.16291046142584 22.734355926513786 0, 86.159423828125 22.736248016357536 0, 86.1585311889649 22.746791839599553 0, 86.15714263916016 22.748874664306754 0, 86.15969085693371 22.75660514831543 0, 86.16392517089855 22.762054443359432 0, 86.16928100585932 22.764049530029354 0, 86.17198181152344 22.78541374206543 0, 86.17166137695318 22.78904724121088 0, 86.17146301269537 22.791240692138615 0, 86.17041778564464 22.794324874877873 0, 86.16733551025402 22.79426574707037 0, 86.16390991210949 22.795417785644588 0, 86.16005706787115 22.80018234252941 0, 86.15735626220709 22.801952362060547 0, 86.14654541015636 22.79815101623541 0, 86.14503479003918 22.799961090088004 0, 86.14364624023443 22.80628585815441 0, 86.14650726318365 22.814371109008846 0, 86.15587615966808 22.821180343628043 0, 86.15681457519537 22.824092864990234 0, 86.1568222045899 22.83487510681158 0, 86.15917968749994 22.838466644287166 0, 86.17367553710932 22.833822250366154 0, 86.1800384521485 22.82545280456543 0, 86.1836166381836 22.823280334472713 0, 86.19445037841808 22.818967819213867 0, 86.19430541992188 22.828466415405217 0, 86.19892883300787 22.837863922119197 0, 86.1976776123048 22.840864181518498 0, 86.1984100341798 22.8480224609375 0, 86.19800567626959 22.86241722106928 0, 86.20063781738287 22.86756324768072 0, 86.20652770996094 22.872299194335994 0, 86.20948028564464 22.873653411865234 0, 86.2156219482423 22.886617660522575 0, 86.21765899658209 22.89092254638672 0, 86.21138763427746 22.892837524414062 0, 86.20840454101562 22.892959594726676 0, 86.19817352294928 22.8994598388673 0, 86.19480895996105 22.89775466918951 0, 86.19160461425776 22.89945220947277 0, 86.18984985351574 22.904407501220703 0, 86.19051361083984 22.90991020202631 0, 86.1880493164063 22.92309761047369 0, 86.18972778320312 22.92699432373047 0, 86.19226837158209 22.93020820617687 0, 86.18950653076166 22.934928894043082 0, 86.19152832031256 22.945999145507926 0, 86.18645477294916 22.94823265075695 0, 86.19533538818365 22.969621658325252 0, 86.20362854003906 22.970298767089844 0, 86.21530151367188 22.968807220458928 0, 86.21860504150396 22.973373413085994 0, 86.22531890869152 22.974205017089957 0, 86.23002624511724 22.972721099853572 0, 86.23602294921886 22.973304748535156 0, 86.23943328857433 22.97583770751953 0, 86.24278259277344 22.981414794921932 0, 86.24392700195312 22.98874092102062 0, 86.24020385742199 22.992027282714844 0, 86.23793792724621 22.99663734436035 0, 86.23793029785168 22.99665451049799 0))",both
PALAMU,1936319,1003876,932443,381,"POLYGON Z ((83.86406707763666 24.53684806823742 0, 83.87381744384766 24.532451629638615 0, 83.88462066650402 24.536067962646428 0, 83.90851593017578 24.54202651977539 0, 83.92369842529303 24.54538154602045 0, 83.92983245849621 24.545801162719727 0, 83.93421936035168 24.547506332397518 0, 83.93875885009771 24.55133438110346 0, 83.94224548339855 24.555515289306754 0, 83.95391845703125 24.566087722778377 0, 83.96333312988287 24.575920104980526 0, 83.97064208984386 24.58721733093273 0, 83.96723937988293 24.596956253051815 0, 83.97785949707037 24.61820602416998 0, 83.99798583984375 24.63756370544445 0, 84.00775146484375 24.634948730468864 0, 84.02029418945312 24.631202697753906 0, 84.02141571044916 24.627164840698242 0, 84.02539825439464 24.626396179199162 0, 84.02993011474615 24.62862777709961 0, 84.03254699707031 24.62731361389166 0, 84.03472900390636 24.62222099304205 0, 84.0377883911134 24.621166229248047 0, 84.03900146484375 24.618553161621207 0, 84.04397583007812 24.619003295898438 0, 84.05247497558605 24.61190223693859 0, 84.05060577392572 24.606576919555778 0, 84.05358886718756 24.606132507324332 0, 84.05884552001953 24.594339370727653 0, 84.05713653564453 24.591159820556754 0, 84.05864715576172 24.58761215209961 0, 84.06379699707031 24.588012695312614 0, 84.06705474853516 24.589012145996037 0, 84.06836700439453 24.58337783813471 0, 84.06546020507824 24.576656341552848 0, 84.07097625732433 24.574733734130916 0, 84.07344055175793 24.57071113586437 0, 84.07817840576178 24.569286346435547 0, 84.08037567138672 24.564439773559513 0, 84.07938385009777 24.557279586792106 0, 84.08292388916021 24.552196502685604 0, 84.08403015136719 24.544731140136832 0, 84.08998107910162 24.538427352905273 0, 84.09437561035162 24.53581619262701 0, 84.09535980224615 24.53367614746105 0, 84.09224700927734 24.514390945434627 0, 84.09474945068365 24.503913879394645 0, 84.10260772705084 24.495519638061523 0, 84.10655212402344 24.48771286010748 0, 84.1154022216798 24.481227874755916 0, 84.12821197509777 24.4865016937257 0, 84.13054656982422 24.498136520385856 0, 84.13465118408209 24.500503540039006 0, 84.14216613769531 24.502359390258846 0, 84.14558410644526 24.504613876342887 0, 84.14264678955084 24.517976760864258 0, 84.14193725585949 24.529148101806697 0, 84.1517105102539 24.540071487426758 0, 84.15518951416016 24.54006767272955 0, 84.16628265380865 24.53803443908697 0, 84.17005157470703 24.53351593017578 0, 84.16134643554693 24.524152755737305 0, 84.16151428222662 24.51929855346674 0, 84.15926361083996 24.51745033264166 0, 84.16675567626947 24.512411117553768 0, 84.176986694336 24.509632110595703 0, 84.18486785888683 24.510257720947322 0, 84.18786621093756 24.5154647827149 0, 84.18786621093756 24.518180847168026 0, 84.19203948974615 24.52233695983898 0, 84.18801116943365 24.5234375 0, 84.1784439086914 24.54177665710455 0, 84.17852020263678 24.54692268371582 0, 84.18721008300781 24.54685592651373 0, 84.19260406494146 24.54909896850586 0, 84.19392395019537 24.555109024047795 0, 84.20552062988281 24.55682373046875 0, 84.20612335205084 24.549255371093807 0, 84.21183013916016 24.545148849487305 0, 84.2145385742188 24.536996841430664 0, 84.22308349609375 24.53501510620123 0, 84.22628784179688 24.55015373229986 0, 84.24061584472656 24.553020477295036 0, 84.23986053466797 24.543426513671818 0, 84.24668121337885 24.54307174682623 0, 84.25386810302746 24.5386199951173 0, 84.25553894042974 24.535612106323242 0, 84.25410461425793 24.531459808349723 0, 84.2627182006836 24.530633926391715 0, 84.26403808593744 24.537567138671875 0, 84.26832580566412 24.53697967529297 0, 84.27031707763683 24.540439605713004 0, 84.27503967285168 24.541244506835994 0, 84.27417755126953 24.546726226806754 0, 84.2838592529298 24.547348022460994 0, 84.28566741943365 24.551786422729492 0, 84.27748107910162 24.5538787841798 0, 84.27483367919928 24.56410217285162 0, 84.28556060791027 24.563215255737248 0, 84.29854583740246 24.565849304199276 0, 84.30300903320312 24.563011169433707 0, 84.30757141113281 24.547143936157227 0, 84.31500244140625 24.53945350646967 0, 84.3174819946289 24.533678054809627 0, 84.3183975219726 24.5267009735108 0, 84.3246536254884 24.522253036499023 0, 84.32723999023443 24.51313400268566 0, 84.3318710327149 24.502687454223633 0, 84.33117675781244 24.49668502807623 0, 84.32722473144531 24.48973655700695 0, 84.3137664794923 24.48687171936035 0, 84.29972076416016 24.480730056762695 0, 84.29077911376953 24.465900421142578 0, 84.29574584960938 24.458082199096793 0, 84.29872131347668 24.450834274292106 0, 84.32051086425781 24.447544097900504 0, 84.33589172363293 24.43125152587902 0, 84.33613586425776 24.428495407104606 0, 84.33296203613287 24.427806854248047 0, 84.32489776611328 24.429307937622127 0, 84.320556640625 24.42350959777832 0, 84.32371520996105 24.420284271240348 0, 84.33036041259777 24.42372894287115 0, 84.33328247070312 24.422229766845703 0, 84.333267211914 24.416648864746094 0, 84.3313446044923 24.411014556884766 0, 84.33710479736328 24.40474891662609 0, 84.34343719482422 24.401401519775504 0, 84.3413314819336 24.395946502685547 0, 84.35242462158209 24.39219474792486 0, 84.36074066162104 24.39109992980957 0, 84.36681365966808 24.386779785156364 0, 84.37271118164074 24.387111663818303 0, 84.3792190551759 24.391138076782227 0, 84.38766479492188 24.389854431152457 0, 84.39044189453136 24.379508972168026 0, 84.397445678711 24.37593650817871 0, 84.4030990600586 24.377588272094727 0, 84.40519714355469 24.37483024597168 0, 84.40035247802746 24.36798858642578 0, 84.42794036865234 24.359388351440487 0, 84.42357635498053 24.342605590820312 0, 84.42282104492193 24.331623077392578 0, 84.45029449462896 24.334457397460994 0, 84.45204162597668 24.33997344970703 0, 84.45991516113276 24.338924407958984 0, 84.46731567382824 24.3178653717041 0, 84.470458984375 24.308715820312557 0, 84.4737396240235 24.305604934692496 0, 84.48067474365246 24.30289840698248 0, 84.48390960693371 24.30323219299322 0, 84.4924087524414 24.305175781250114 0, 84.49407958984375 24.302524566650447 0, 84.49282073974615 24.29919242858898 0, 84.48953247070312 24.297275543212834 0, 84.49885559082031 24.287418365478516 0, 84.48346710205084 24.276580810546818 0, 84.48629760742188 24.27018928527832 0, 84.48659515380871 24.26466751098627 0, 84.48188018798828 24.26301383972168 0, 84.4640579223634 24.259681701660213 0, 84.46826934814464 24.26300239562994 0, 84.47080993652344 24.26627731323248 0, 84.46958923339855 24.26829338073742 0, 84.46499633789068 24.265716552734318 0, 84.45553588867182 24.26811408996582 0, 84.4542846679688 24.26144790649414 0, 84.44274902343744 24.244115829467717 0, 84.44645690917974 24.23945236206066 0, 84.46715545654308 24.232011795043945 0, 84.47142028808594 24.229227066040096 0, 84.47219848632818 24.21991539001465 0, 84.47118377685547 24.210647583007812 0, 84.47439575195324 24.207529067993278 0, 84.486557006836 24.201789855957145 0, 84.49946594238281 24.200004577636776 0, 84.50898742675781 24.201164245605526 0, 84.5190658569336 24.2000350952149 0, 84.52680969238293 24.207365036010742 0, 84.53446197509777 24.203474044799748 0, 84.53531646728516 24.19944572448742 0, 84.52632141113281 24.19176483154297 0, 84.52980804443365 24.181272506713924 0, 84.53301239013672 24.177978515624943 0, 84.53643798828125 24.171216964721793 0, 84.54298400878912 24.1685409545899 0, 84.54776000976568 24.160974502563533 0, 84.55001831054693 24.153587341308594 0, 84.578109741211 24.141965866088924 0, 84.5702743530274 24.11849403381359 0, 84.56279754638678 24.11651802062994 0, 84.55175018310553 24.103799819946403 0, 84.56117248535168 24.078142166137695 0, 84.5727157592774 24.070903778076172 0, 84.56495666503918 24.056041717529297 0, 84.56203460693365 24.052591323852596 0, 84.5514373779298 24.050067901611442 0, 84.55213928222662 24.043951034545955 0, 84.55928802490229 24.037521362304744 0, 84.5623779296875 24.03343009948736 0, 84.55463409423834 24.02729606628418 0, 84.5519409179688 24.016740798950252 0, 84.55693054199224 24.00307273864746 0, 84.56407165527344 23.991157531738338 0, 84.5684814453125 23.98533630371088 0, 84.57087707519543 23.984291076660213 0, 84.57415771484386 23.98570251464838 0, 84.58346557617199 23.98673057556158 0, 84.58401489257818 23.98248291015625 0, 84.58621978759766 23.97946739196783 0, 84.58443450927746 23.971597671508903 0, 84.58139801025402 23.968004226684684 0, 84.5722122192384 23.963302612304744 0, 84.56889343261719 23.957506179809684 0, 84.56690216064464 23.949182510375977 0, 84.56757354736334 23.943340301513672 0, 84.57017517089844 23.937015533447266 0, 84.56955718994152 23.933715820312557 0, 84.56264495849615 23.92802619934082 0, 84.5584106445313 23.927324295044002 0, 84.52999877929693 23.93166732788086 0, 84.52797698974621 23.928318023681697 0, 84.52906036376959 23.924968719482365 0, 84.52577209472656 23.922670364379883 0, 84.51690673828136 23.921274185180778 0, 84.516098022461 23.918350219726676 0, 84.51757049560547 23.914529800415096 0, 84.51837921142584 23.91350746154785 0, 84.52188873291027 23.909059524536246 0, 84.52345275878906 23.9049587249757 0, 84.52311706542969 23.901100158691463 0, 84.51544189453125 23.899482727050895 0, 84.50662231445324 23.899282455444336 0, 84.49401092529308 23.894033432006893 0, 84.49452209472662 23.900098800659237 0, 84.48252105712896 23.89492225646984 0, 84.47888946533209 23.90866279602062 0, 84.46967315673828 23.91455268859869 0, 84.46757507324219 23.917745590210075 0, 84.46898651123053 23.926641464233455 0, 84.47164916992193 23.928314208984375 0, 84.47592163085949 23.92736053466797 0, 84.4770889282226 23.93211746215826 0, 84.4758987426759 23.938140869140682 0, 84.46871948242188 23.945167541503963 0, 84.4668579101563 23.949274063110465 0, 84.46665954589844 23.955083847045955 0, 84.45739746093761 23.953880310058594 0, 84.45329284667969 23.959987640380916 0, 84.44944763183594 23.96184921264654 0, 84.44521331787121 23.961235046386776 0, 84.44005584716808 23.951158523559627 0, 84.43656921386724 23.948680877685547 0, 84.43242645263683 23.94778633117687 0, 84.4236297607423 23.948593139648494 0, 84.41567993164062 23.947717666626033 0, 84.41283416748047 23.946418762206974 0, 84.40290069580078 23.934450149536076 0, 84.39916992187506 23.933820724487305 0, 84.37636566162121 23.941106796264705 0, 84.36323547363281 23.941112518310604 0, 84.35857391357428 23.942535400390682 0, 84.3490447998048 23.948425292968807 0, 84.34204101562494 23.951757431030273 0, 84.33943176269531 23.948514938354492 0, 84.33815002441412 23.940166473388786 0, 84.33539581298828 23.93287467956543 0, 84.33477783203136 23.93021774291998 0, 84.3330535888673 23.92280769348139 0, 84.32986450195312 23.920318603515625 0, 84.33205413818365 23.910768508911246 0, 84.32878875732428 23.90920066833496 0, 84.32577514648449 23.90891838073736 0, 84.31755065917974 23.905649185180607 0, 84.31307983398438 23.906789779663143 0, 84.3090286254884 23.905612945556697 0, 84.3042678833009 23.910076141357365 0, 84.30383300781256 23.912115097045955 0, 84.29154205322266 23.91605377197277 0, 84.28611755371105 23.90662384033203 0, 84.28311920166016 23.903852462768555 0, 84.26875305175793 23.90259552001953 0, 84.25996398925787 23.900444030761662 0, 84.254150390625 23.90042114257824 0, 84.25106811523432 23.89820480346691 0, 84.25074005126953 23.89434432983404 0, 84.24562072753912 23.887853622436523 0, 84.24174499511719 23.885841369628963 0, 84.23985290527344 23.895198822021428 0, 84.24038696289057 23.899330139160156 0, 84.2449188232423 23.90815353393566 0, 84.25016784667969 23.916378021240178 0, 84.25135803222662 23.925373077392578 0, 84.24891662597668 23.927190780639705 0, 84.2444915771485 23.926668167114258 0, 84.24051666259777 23.924751281738338 0, 84.23781585693365 23.92124176025385 0, 84.23371124267572 23.915912628173885 0, 84.22930908203136 23.912900924682674 0, 84.22267150878906 23.912162780761776 0, 84.22247314453125 23.90922164916998 0, 84.22117614746094 23.90630912780756 0, 84.2127685546875 23.9065399169923 0, 84.21290588378918 23.91381454467779 0, 84.21088409423828 23.91644859313965 0, 84.20708465576178 23.91683006286621 0, 84.20153045654297 23.91541671752924 0, 84.19795227050787 23.916343688964844 0, 84.19545745849615 23.922861099243164 0, 84.19277191162115 23.92661857604986 0, 84.18469238281244 23.930801391601562 0, 84.17668914794922 23.934427261352653 0, 84.16221618652344 23.936294555664176 0, 84.13798522949219 23.943216323852482 0, 84.14105987548828 23.92655181884777 0, 84.14330291748041 23.921422958374023 0, 84.1435317993164 23.919206619262695 0, 84.13583374023449 23.900991439819336 0, 84.12690734863281 23.897638320922795 0, 84.12151336669933 23.898059844970646 0, 84.11278533935541 23.894609451293945 0, 84.09521484375011 23.87444496154791 0, 84.09239196777344 23.867427825927734 0, 84.08999633789068 23.864543914794922 0, 84.08620452880865 23.861881256103516 0, 84.08440399169922 23.861480712890682 0, 84.07585906982428 23.859586715698185 0, 84.06804656982428 23.85785102844244 0, 84.06478118896484 23.85581970214838 0, 84.0613021850586 23.850383758544865 0, 84.05751037597656 23.837957382202205 0, 84.04885101318371 23.830171585083008 0, 84.04927825927734 23.821224212646484 0, 84.05225372314459 23.814052581787166 0, 84.03895568847668 23.805099487304688 0, 84.03672790527344 23.79465675354004 0, 84.03362274169916 23.79123878479004 0, 84.03135681152344 23.792404174804744 0, 84.02701568603516 23.797767639160213 0, 84.02265167236334 23.79897117614746 0, 84.02588653564459 23.80323410034191 0, 84.02511596679693 23.807399749755916 0, 84.02551269531256 23.810520172119084 0, 84.02272033691418 23.81427764892578 0, 84.02022552490246 23.814527511596793 0, 84.00897216796886 23.81316566467285 0, 83.9976654052735 23.816778182983455 0, 83.98737335205084 23.82717895507824 0, 83.98168182373053 23.837459564208984 0, 83.97940826416027 23.85133743286127 0, 83.97488403320307 23.860757827758846 0, 83.96313476562506 23.86631393432623 0, 83.95144653320312 23.867351531982365 0, 83.9416885375976 23.872577667236328 0, 83.93440246582043 23.883268356323242 0, 83.9295425415039 23.894630432128963 0, 83.91880798339838 23.904300689697322 0, 83.9179306030274 23.915008544921875 0, 83.93515777587902 23.934465408325195 0, 83.93476867675793 23.938251495361385 0, 83.92989349365234 23.942613601684684 0, 83.9188232421875 23.949235916137752 0, 83.90717315673822 23.956920623779354 0, 83.90122985839855 23.965915679931754 0, 83.89836883544933 23.974094390869197 0, 83.89579772949224 23.985305786132926 0, 83.89158630371094 23.99195289611822 0, 83.88700103759766 23.996213912963867 0, 83.88319396972656 23.996217727661246 0, 83.87643432617199 23.99141502380371 0, 83.86013793945318 23.974880218505973 0, 83.85458374023438 23.969114303588867 0, 83.84808349609375 23.962007522583065 0, 83.8350296020509 23.961229324340877 0, 83.82530975341808 23.968013763427848 0, 83.82528686523449 23.970592498779297 0, 83.82835388183605 23.975950241088867 0, 83.83503723144543 23.983963012695426 0, 83.8370971679688 23.987062454223746 0, 83.83901977539074 23.994291305541992 0, 83.83856964111328 23.99936866760254 0, 83.8332977294923 24.011014938354606 0, 83.83353424072277 24.022430419921932 0, 83.84095764160168 24.03265380859375 0, 83.85043334960943 24.040891647338924 0, 83.88067626953125 24.07955360412609 0, 83.88931274414068 24.086427688598746 0, 83.91426086425781 24.095188140869197 0, 83.92993927001959 24.09607887268072 0, 83.94095611572266 24.09846687316906 0, 83.95558929443371 24.107761383056697 0, 83.96145629882818 24.109361648559513 0, 83.97595977783209 24.101156234741268 0, 83.9808578491211 24.108661651611328 0, 83.9812622070313 24.120958328247184 0, 83.98099517822266 24.13114738464367 0, 83.97793579101557 24.14587211608881 0, 83.97370910644543 24.15121841430664 0, 83.94458770751953 24.158025741577205 0, 83.91918182373041 24.16874504089367 0, 83.90409088134777 24.183435440063533 0, 83.87947845458996 24.20249366760254 0, 83.86478424072277 24.21162414550787 0, 83.85645294189453 24.230283737182674 0, 83.84374237060553 24.24814987182623 0, 83.82151031494152 24.27911758422863 0, 83.81118774414074 24.296586990356502 0, 83.81118774414074 24.302938461303768 0, 83.81712341308605 24.319700241088867 0, 83.81762695312506 24.326713562011832 0, 83.81800079345709 24.33194541931158 0, 83.81252288818371 24.34387016296381 0, 83.80737304687511 24.354118347168026 0, 83.80277252197271 24.36769104003912 0, 83.80545806884777 24.380336761474666 0, 83.81272125244152 24.38789367675787 0, 83.82967376708996 24.396104812622127 0, 83.84091949462896 24.409481048583984 0, 83.84274291992188 24.423027038574332 0, 83.84729766845703 24.458415985107536 0, 83.84592437744152 24.471292495727596 0, 83.84571075439464 24.4771347045899 0, 83.84883880615234 24.50263214111328 0, 83.84973907470714 24.509471893310604 0, 83.85398864746094 24.52032661437994 0, 83.8570556640625 24.525407791137695 0, 83.86406707763666 24.53684806823742 0))",both
LATEHAR,725673,369534,356139,200,"POLYGON Z ((84.02265167236334 23.79897117614746 0, 84.02701568603516 23.797767639160213 0, 84.03135681152344 23.792404174804744 0, 84.03362274169916 23.79123878479004 0, 84.03672790527344 23.79465675354004 0, 84.03895568847668 23.805099487304688 0, 84.05225372314459 23.814052581787166 0, 84.04927825927734 23.821224212646484 0, 84.04885101318371 23.830171585083008 0, 84.05751037597656 23.837957382202205 0, 84.0613021850586 23.850383758544865 0, 84.06478118896484 23.85581970214838 0, 84.06804656982428 23.85785102844244 0, 84.07585906982428 23.859586715698185 0, 84.08440399169922 23.861480712890682 0, 84.08620452880865 23.861881256103516 0, 84.08999633789068 23.864543914794922 0, 84.09239196777344 23.867427825927734 0, 84.09521484375011 23.87444496154791 0, 84.11278533935541 23.894609451293945 0, 84.12151336669933 23.898059844970646 0, 84.12690734863281 23.897638320922795 0, 84.13583374023449 23.900991439819336 0, 84.1435317993164 23.919206619262695 0, 84.14330291748041 23.921422958374023 0, 84.14105987548828 23.92655181884777 0, 84.13798522949219 23.943216323852482 0, 84.16221618652344 23.936294555664176 0, 84.17668914794922 23.934427261352653 0, 84.18469238281244 23.930801391601562 0, 84.19277191162115 23.92661857604986 0, 84.19545745849615 23.922861099243164 0, 84.19795227050787 23.916343688964844 0, 84.20153045654297 23.91541671752924 0, 84.20708465576178 23.91683006286621 0, 84.21088409423828 23.91644859313965 0, 84.21290588378918 23.91381454467779 0, 84.2127685546875 23.9065399169923 0, 84.22117614746094 23.90630912780756 0, 84.22247314453125 23.90922164916998 0, 84.22267150878906 23.912162780761776 0, 84.22930908203136 23.912900924682674 0, 84.23371124267572 23.915912628173885 0, 84.23781585693365 23.92124176025385 0, 84.24051666259777 23.924751281738338 0, 84.2444915771485 23.926668167114258 0, 84.24891662597668 23.927190780639705 0, 84.25135803222662 23.925373077392578 0, 84.25016784667969 23.916378021240178 0, 84.2449188232423 23.90815353393566 0, 84.24038696289057 23.899330139160156 0, 84.23985290527344 23.895198822021428 0, 84.24174499511719 23.885841369628963 0, 84.24562072753912 23.887853622436523 0, 84.25074005126953 23.89434432983404 0, 84.25106811523432 23.89820480346691 0, 84.254150390625 23.90042114257824 0, 84.25996398925787 23.900444030761662 0, 84.26875305175793 23.90259552001953 0, 84.28311920166016 23.903852462768555 0, 84.28611755371105 23.90662384033203 0, 84.29154205322266 23.91605377197277 0, 84.30383300781256 23.912115097045955 0, 84.3042678833009 23.910076141357365 0, 84.3090286254884 23.905612945556697 0, 84.31307983398438 23.906789779663143 0, 84.31755065917974 23.905649185180607 0, 84.32577514648449 23.90891838073736 0, 84.32878875732428 23.90920066833496 0, 84.33205413818365 23.910768508911246 0, 84.32986450195312 23.920318603515625 0, 84.3330535888673 23.92280769348139 0, 84.33477783203136 23.93021774291998 0, 84.33539581298828 23.93287467956543 0, 84.33815002441412 23.940166473388786 0, 84.33943176269531 23.948514938354492 0, 84.34204101562494 23.951757431030273 0, 84.3490447998048 23.948425292968807 0, 84.35857391357428 23.942535400390682 0, 84.36323547363281 23.941112518310604 0, 84.37636566162121 23.941106796264705 0, 84.39916992187506 23.933820724487305 0, 84.40290069580078 23.934450149536076 0, 84.41283416748047 23.946418762206974 0, 84.41567993164062 23.947717666626033 0, 84.4236297607423 23.948593139648494 0, 84.43242645263683 23.94778633117687 0, 84.43656921386724 23.948680877685547 0, 84.44005584716808 23.951158523559627 0, 84.44521331787121 23.961235046386776 0, 84.44944763183594 23.96184921264654 0, 84.45329284667969 23.959987640380916 0, 84.45739746093761 23.953880310058594 0, 84.46665954589844 23.955083847045955 0, 84.4668579101563 23.949274063110465 0, 84.46871948242188 23.945167541503963 0, 84.4758987426759 23.938140869140682 0, 84.4770889282226 23.93211746215826 0, 84.47592163085949 23.92736053466797 0, 84.47164916992193 23.928314208984375 0, 84.46898651123053 23.926641464233455 0, 84.46757507324219 23.917745590210075 0, 84.46967315673828 23.91455268859869 0, 84.47888946533209 23.90866279602062 0, 84.48252105712896 23.89492225646984 0, 84.49452209472662 23.900098800659237 0, 84.49401092529308 23.894033432006893 0, 84.50662231445324 23.899282455444336 0, 84.51544189453125 23.899482727050895 0, 84.52311706542969 23.901100158691463 0, 84.52345275878906 23.9049587249757 0, 84.52188873291027 23.909059524536246 0, 84.51837921142584 23.91350746154785 0, 84.51757049560547 23.914529800415096 0, 84.516098022461 23.918350219726676 0, 84.51690673828136 23.921274185180778 0, 84.52577209472656 23.922670364379883 0, 84.52906036376959 23.924968719482365 0, 84.52797698974621 23.928318023681697 0, 84.52999877929693 23.93166732788086 0, 84.5584106445313 23.927324295044002 0, 84.56264495849615 23.92802619934082 0, 84.56955718994152 23.933715820312557 0, 84.57017517089844 23.937015533447266 0, 84.56757354736334 23.943340301513672 0, 84.56690216064464 23.949182510375977 0, 84.56889343261719 23.957506179809684 0, 84.5722122192384 23.963302612304744 0, 84.58139801025402 23.968004226684684 0, 84.58443450927746 23.971597671508903 0, 84.58621978759766 23.97946739196783 0, 84.58401489257818 23.98248291015625 0, 84.58346557617199 23.98673057556158 0, 84.58347320556652 23.986732482910156 0, 84.58840942382818 23.98761558532715 0, 84.59095001220697 23.98710441589361 0, 84.59664916992199 23.98352432250971 0, 84.60430145263666 23.990055084228516 0, 84.60536193847662 23.989816665649414 0, 84.61360931396496 23.983062744140625 0, 84.61703491210949 23.984054565429688 0, 84.6205215454101 23.983875274658317 0, 84.62316131591808 23.982891082763786 0, 84.62724304199219 23.980739593505916 0, 84.62975311279303 23.98192977905279 0, 84.63537597656261 23.991247177124023 0, 84.63905334472656 23.998098373413086 0, 84.64470672607433 24.005672454833984 0, 84.6529006958009 24.007345199585018 0, 84.65953826904303 24.005342483520565 0, 84.66371154785162 24.00163078308117 0, 84.66863250732422 24.002227783203182 0, 84.67354583740229 24.004978179931697 0, 84.67591857910162 24.010389328002987 0, 84.67990875244146 24.01394844055187 0, 84.68286895751964 24.020343780517578 0, 84.68666839599621 24.02398109436041 0, 84.69151306152344 24.024604797363395 0, 84.6991195678711 24.023199081421012 0, 84.70960235595703 24.027370452880973 0, 84.70730590820307 24.03269767761236 0, 84.70761871337896 24.039691925048885 0, 84.71839904785156 24.044935226440543 0, 84.72752380371088 24.041484832763786 0, 84.73198699951178 24.043533325195312 0, 84.7371673583985 24.047216415405387 0, 84.74087524414057 24.048568725585994 0, 84.74457550048834 24.040121078491268 0, 84.7509155273438 24.04297256469738 0, 84.7521743774414 24.041744232177734 0, 84.74926757812494 24.034538269042912 0, 84.7499008178711 24.03260231018072 0, 84.75650024414074 24.027410507202262 0, 84.76111602783203 24.01678085327154 0, 84.76668548583984 24.012702941894588 0, 84.7679672241211 24.009141921997127 0, 84.76024627685553 23.991304397583008 0, 84.7578506469726 23.986484527587947 0, 84.76171875 23.978338241577205 0, 84.76445770263678 23.978796005248967 0, 84.76622772216808 23.978378295898494 0, 84.76674652099615 23.977207183838004 0, 84.7659301757813 23.97609710693365 0, 84.76387023925787 23.97573089599615 0, 84.760009765625 23.969915390014705 0, 84.75781250000011 23.969161987304688 0, 84.75714111328125 23.967525482177734 0, 84.76978302001959 23.966358184814396 0, 84.77217864990234 23.967216491699162 0, 84.77772521972656 23.969970703125057 0, 84.78271484375006 23.970174789428825 0, 84.79055023193365 23.969196319580192 0, 84.79751586914057 23.9716472625733 0, 84.80331420898443 23.970279693603572 0, 84.80782318115229 23.975944519043082 0, 84.81316375732416 23.979990005493278 0, 84.82334136962896 23.983791351318416 0, 84.82302093505871 23.971632003784237 0, 84.82823944091797 23.957931518554688 0, 84.84387969970703 23.965461730957145 0, 84.85037994384766 23.963655471801758 0, 84.86184692382812 23.95592689514166 0, 84.86927032470703 23.954183578491154 0, 84.876937866211 23.95424461364746 0, 84.88206481933594 23.952489852905273 0, 84.88565063476562 23.948434829711914 0, 84.8871841430664 23.94327735900879 0, 84.8921890258789 23.944913864135742 0, 84.8975677490235 23.948616027832088 0, 84.90414428710932 23.95059204101574 0, 84.92094421386719 23.951110839843807 0, 84.92298889160168 23.948160171508903 0, 84.93121337890636 23.94034004211437 0, 84.93305969238287 23.935302734375114 0, 84.9311981201173 23.931203842163143 0, 84.92813110351574 23.927614212036133 0, 84.92701721191418 23.92060852050787 0, 84.92445373535162 23.916017532348633 0, 84.92471313476574 23.91234588623047 0, 84.9327621459961 23.910921096801815 0, 84.93795776367188 23.90625381469738 0, 84.94370269775396 23.891931533813477 0, 84.94615173339844 23.882415771484432 0, 84.94746398925781 23.881950378417912 0, 84.94747161865234 23.874820709228516 0, 84.94401550292969 23.872400283813533 0, 84.93756103515625 23.870388031005973 0, 84.93212127685558 23.867008209228516 0, 84.92857360839844 23.862085342407283 0, 84.92724609375 23.85891532897955 0, 84.93069458007812 23.856519699096793 0, 84.94104003906256 23.853252410888615 0, 84.94558715820312 23.842861175537166 0, 84.94615936279297 23.835599899291992 0, 84.94553375244135 23.829368591308594 0, 84.94240570068365 23.82483291625971 0, 84.94415283203136 23.819328308105526 0, 84.94282531738293 23.80311584472662 0, 84.93749237060558 23.80261993408203 0, 84.91545867919922 23.804857254028377 0, 84.9098358154298 23.802299499511776 0, 84.90692901611334 23.800090789794922 0, 84.90534210205078 23.797201156616325 0, 84.90410614013683 23.79169654846197 0, 84.90488433837902 23.788919448852482 0, 84.9019393920899 23.78415107727045 0, 84.90084838867199 23.775587081909237 0, 84.90777587890625 23.772241592407283 0, 84.91911315917974 23.770874023437557 0, 84.92572784423828 23.76842689514166 0, 84.9250946044923 23.76383209228527 0, 84.92646789550781 23.75164985656744 0, 84.93354797363281 23.737634658813477 0, 84.93637847900385 23.72947502136242 0, 84.93900299072277 23.727600097656364 0, 84.95932006835938 23.721887588501033 0, 84.95891571044922 23.712490081787053 0, 84.96174621582026 23.71431541442871 0, 84.96345520019526 23.7071990966798 0, 84.96249389648449 23.70201301574707 0, 84.95999145507824 23.69608497619629 0, 84.95469665527344 23.69770622253418 0, 84.94714355468756 23.701923370361385 0, 84.94213104248047 23.697847366333065 0, 84.939926147461 23.69440650939947 0, 84.93291473388683 23.69134712219244 0, 84.931869506836 23.68779373168951 0, 84.93352508544922 23.681875228881836 0, 84.92461395263672 23.67514801025402 0, 84.92091369628918 23.669839859008846 0, 84.92044067382818 23.667417526245174 0, 84.92220306396496 23.664482116699332 0, 84.91719055175787 23.65308380126953 0, 84.91790771484375 23.649469375610465 0, 84.92028808593756 23.64682579040533 0, 84.94001007080078 23.63672256469738 0, 84.94060516357422 23.632944107055664 0, 84.94031524658209 23.62075424194336 0, 84.9434051513673 23.608179092407283 0, 84.9419174194336 23.601070404052848 0, 84.93234252929699 23.57740020751953 0, 84.93094635009771 23.572322845458984 0, 84.93180847167969 23.566909790039062 0, 84.9339370727539 23.563194274902457 0, 84.93254852294933 23.55061149597168 0, 84.9219818115235 23.553283691406364 0, 84.91844940185541 23.546331405639705 0, 84.91419219970714 23.543382644653377 0, 84.9096145629884 23.543525695800838 0, 84.90793609619152 23.546339035034237 0, 84.90740203857422 23.55122947692871 0, 84.90809631347668 23.566303253173885 0, 84.90653991699224 23.572956085205135 0, 84.90629577636719 23.579111099243107 0, 84.90380096435547 23.581979751586857 0, 84.89987182617193 23.578857421875114 0, 84.8944320678711 23.559230804443416 0, 84.89083862304688 23.558092117309684 0, 84.88420867919928 23.558069229126033 0, 84.87458038330072 23.558151245117188 0, 84.87077331542969 23.5450057983399 0, 84.86680603027344 23.544086456298828 0, 84.86428070068354 23.541259765625114 0, 84.85831451416027 23.542264938354492 0, 84.85475158691406 23.53605079650879 0, 84.85166168212902 23.533678054809684 0, 84.81977844238293 23.5443172454834 0, 84.81875610351562 23.54825782775879 0, 84.8205184936524 23.565477371215877 0, 84.81862640380865 23.56891059875494 0, 84.81538391113287 23.569190979003906 0, 84.80537414550781 23.56312179565441 0, 84.80090332031261 23.562936782836914 0, 84.79812622070312 23.56625747680664 0, 84.79901123046886 23.57703399658203 0, 84.79577636718761 23.577869415283203 0, 84.79293823242182 23.575662612915153 0, 84.792236328125 23.571367263794002 0, 84.79161071777338 23.56499481201172 0, 84.79265594482428 23.56093406677246 0, 84.79121398925793 23.55528450012207 0, 84.79074096679693 23.54552078247076 0, 84.7882080078125 23.5450057983399 0, 84.78304290771484 23.5460586547851 0, 84.7807083129884 23.549489974975586 0, 84.77923583984375 23.554674148559684 0, 84.78271484375006 23.566196441650334 0, 84.78303527832031 23.571901321411133 0, 84.77420043945324 23.57344436645502 0, 84.77170562744146 23.57501792907709 0, 84.77083587646484 23.580659866333008 0, 84.76553344726562 23.583179473876953 0, 84.76389312744152 23.585649490356445 0, 84.76406097412115 23.59394645690918 0, 84.76100158691412 23.6009902954101 0, 84.75624084472662 23.60543251037592 0, 84.7506942749024 23.607440948486328 0, 84.74552917480474 23.608379364013672 0, 84.74302673339844 23.610397338867188 0, 84.74179840087902 23.627206802368164 0, 84.7401351928711 23.63165855407709 0, 84.73732757568365 23.632722854614258 0, 84.73618316650396 23.63626861572277 0, 84.73348236083984 23.638860702514762 0, 84.7294311523437 23.640247344970703 0, 84.725830078125 23.638875961303825 0, 84.7245101928711 23.635206222534237 0, 84.72412109375 23.62465095520031 0, 84.72235107421886 23.621540069580078 0, 84.71834564208996 23.618305206298828 0, 84.71308135986328 23.6169891357423 0, 84.69978332519537 23.61162757873541 0, 84.69289398193365 23.610071182250977 0, 84.68703460693371 23.606664657592717 0, 84.68202209472662 23.60482978820812 0, 84.67866516113293 23.604593276977596 0, 84.6771621704101 23.617733001708984 0, 84.67252349853521 23.62177467346197 0, 84.66191101074213 23.62629699707037 0, 84.66031646728521 23.629844665527344 0, 84.65901184082043 23.64174652099615 0, 84.65707397460943 23.64817237854004 0, 84.65296173095703 23.654977798462028 0, 84.64649963378906 23.66109275817871 0, 84.64208221435547 23.66660308837885 0, 84.639144897461 23.667888641357422 0, 84.63563537597656 23.66522407531744 0, 84.62181854248058 23.661823272705135 0, 84.61802673339855 23.661804199218864 0, 84.61389923095703 23.6591854095459 0, 84.61116027832043 23.658727645874137 0, 84.60785675048834 23.660062789917106 0, 84.59956359863281 23.668375015258732 0, 84.58834075927734 23.665773391723633 0, 84.58908081054688 23.655059814453182 0, 84.58488464355469 23.641719818115178 0, 84.5823440551759 23.620037078857422 0, 84.58130645751959 23.617321014404297 0, 84.57703399658197 23.616056442260742 0, 84.56357574462896 23.614921569824162 0, 84.55184936523432 23.62907028198248 0, 84.55088043212902 23.6317195892334 0, 84.552993774414 23.63788223266613 0, 84.55293273925787 23.642791748046875 0, 84.54563140869146 23.651330947876033 0, 84.53642272949219 23.668485641479492 0, 84.53409576416027 23.669942855835075 0, 84.52827453613287 23.668214797973633 0, 84.52547454833996 23.668767929077205 0, 84.50710296630865 23.676280975341797 0, 84.50318908691418 23.67665863037115 0, 84.49452209472662 23.67395401000971 0, 84.48842620849615 23.663923263549805 0, 84.47935485839855 23.66382217407238 0, 84.47366333007812 23.66209220886236 0, 84.4680633544923 23.65765953063965 0, 84.4604110717774 23.647624969482365 0, 84.45862579345703 23.642080307006893 0, 84.45893859863293 23.636384963989258 0, 84.46112060546875 23.631597518920955 0, 84.46121215820324 23.628215789794922 0, 84.45537567138672 23.628576278686637 0, 84.45029449462896 23.632553100585994 0, 84.44390869140625 23.636119842529354 0, 84.44004058837902 23.637287139892692 0, 84.43678283691418 23.634269714355526 0, 84.4329452514649 23.632665634155273 0, 84.41851806640636 23.634046554565487 0, 84.41332244873058 23.636779785156307 0, 84.41017150878906 23.640541076660156 0, 84.39385223388678 23.63817214965826 0, 84.39354705810541 23.63383102416998 0, 84.39542388916027 23.622665405273494 0, 84.39514923095709 23.615442276001033 0, 84.3983383178711 23.609708786010856 0, 84.39695739746105 23.6047306060791 0, 84.39131927490234 23.60384178161621 0, 84.37995910644543 23.608118057250977 0, 84.37426757812511 23.60548019409174 0, 84.35726928710949 23.609262466430664 0, 84.3544921875 23.607213973999137 0, 84.34924316406261 23.605316162109432 0, 84.34339904785156 23.60103797912592 0, 84.33918762207026 23.59983062744152 0, 84.34213256835943 23.588792800903434 0, 84.33894348144543 23.585773468017635 0, 84.33307647705072 23.58320045471197 0, 84.31716156005865 23.579132080078125 0, 84.31785583496094 23.574628829955998 0, 84.32348632812511 23.557624816894588 0, 84.32444000244152 23.551311492919865 0, 84.32479858398443 23.538227081298885 0, 84.32654571533214 23.528532028198242 0, 84.32321166992188 23.51784324645996 0, 84.32479858398443 23.511032104492188 0, 84.32556915283209 23.499912261962947 0, 84.32489013671875 23.49495124816906 0, 84.31566619873058 23.492853164672965 0, 84.31506347656256 23.49166488647461 0, 84.31523132324224 23.483539581298885 0, 84.30330657958996 23.484411239623967 0, 84.29115295410156 23.492790222168026 0, 84.28865814208984 23.493446350097656 0, 84.28695678710938 23.491176605224723 0, 84.2829360961914 23.476703643798942 0, 84.27570343017578 23.470394134521598 0, 84.2754364013673 23.467229843139762 0, 84.2676239013673 23.462316513061523 0, 84.25799560546875 23.458131790161246 0, 84.24996185302734 23.451858520507812 0, 84.24762725830072 23.44591712951666 0, 84.24707794189453 23.44033432006836 0, 84.25245666503906 23.428356170654297 0, 84.25428009033214 23.422269821166992 0, 84.2535629272461 23.416118621826172 0, 84.25138092041021 23.412208557128906 0, 84.2507095336914 23.407798767089844 0, 84.25147247314453 23.402225494384766 0, 84.25760650634766 23.38410377502447 0, 84.25861358642584 23.378746032714957 0, 84.2501220703125 23.36966133117687 0, 84.24445343017578 23.35370254516596 0, 84.24179840087896 23.34905624389654 0, 84.22818756103516 23.34325981140131 0, 84.22518157958984 23.340751647949276 0, 84.20414733886713 23.33777046203619 0, 84.19989013671886 23.336210250854435 0, 84.19465637207031 23.32562255859375 0, 84.1923065185548 23.32498168945324 0, 84.16519927978527 23.331079483032283 0, 84.13942718505871 23.338201522827205 0, 84.13523864746105 23.340250015258846 0, 84.13082885742193 23.345468521118107 0, 84.12667846679699 23.345149993896484 0, 84.1169815063476 23.35076522827154 0, 84.11540985107433 23.34466171264654 0, 84.11389160156261 23.34255409240734 0, 84.10734558105474 23.340747833251896 0, 84.10007476806646 23.337532043457088 0, 84.09555053710943 23.329593658447322 0, 84.07666015625006 23.331260681152457 0, 84.07543182373047 23.331369400024414 0, 84.07315063476562 23.33547019958496 0, 84.0656967163086 23.344541549682674 0, 84.05515289306652 23.3531951904298 0, 84.05381011962902 23.35549545288086 0, 84.05254364013672 23.364961624145508 0, 84.04964447021479 23.36843490600586 0, 84.04866790771496 23.371026992797795 0, 84.05065155029297 23.371816635131893 0, 84.05242156982428 23.372524261474666 0, 84.05203247070318 23.372808456421012 0, 84.04859924316412 23.375308990478516 0, 84.04323577880865 23.377464294433537 0, 84.03169250488293 23.378208160400447 0, 84.02693176269543 23.376987457275334 0, 84.02595520019543 23.376735687255973 0, 84.02236175537121 23.37286949157715 0, 84.01666259765625 23.364685058593693 0, 84.01241302490246 23.35552597045904 0, 84.0117416381836 23.354093551635856 0, 83.99799346923828 23.35716819763195 0, 83.98825073242188 23.36081314086914 0, 83.98009490966797 23.366048812866268 0, 83.9754867553711 23.370647430420036 0, 83.97214508056646 23.375459671020508 0, 83.97107696533203 23.38242721557623 0, 83.97303771972656 23.394189834594783 0, 83.9814224243164 23.408716201782283 0, 83.98330688476562 23.415321350097713 0, 83.98341369628918 23.42209625244135 0, 83.98471069335943 23.42784500122076 0, 83.98300933837896 23.432601928710938 0, 83.97499847412115 23.448802947998104 0, 83.9747924804688 23.456523895263615 0, 83.97663116455078 23.457515716552734 0, 83.98440551757824 23.461702346801815 0, 83.98448944091803 23.461931228637752 0, 83.98990631103527 23.47668838500988 0, 83.9941635131836 23.482868194580078 0, 83.99798583984375 23.48627090454096 0, 84.0025100708009 23.494188308715934 0, 84.00402832031261 23.494791030883903 0, 84.01090240478527 23.497539520263672 0, 84.01162719726568 23.498268127441463 0, 84.01402282714844 23.500665664672965 0, 84.01753234863287 23.509220123291016 0, 84.01801300048828 23.52186775207531 0, 84.02067565917969 23.526685714721737 0, 84.02794647216797 23.54526519775402 0, 84.0265579223634 23.550949096679744 0, 84.03038787841791 23.566791534423828 0, 84.02819824218756 23.57557106018072 0, 84.02940368652355 23.588851928710938 0, 84.02722930908209 23.593173980712947 0, 84.02763366699224 23.59831619262701 0, 84.02559661865246 23.601123809814453 0, 84.01786804199224 23.60642051696783 0, 84.00717163085938 23.621341705322266 0, 84.00708007812511 23.623809814453182 0, 84.00891876220709 23.627202987670955 0, 84.01061248779297 23.628118515014705 0, 84.01301574707043 23.629413604736385 0, 84.0129852294923 23.62957954406744 0, 84.01233673095709 23.63319969177246 0, 84.0061492919923 23.633514404296932 0, 84.00684356689459 23.63414001464855 0, 84.00749969482416 23.634712219238395 0, 84.01167297363293 23.63834381103527 0, 84.0259475708009 23.64727210998535 0, 84.0498428344726 23.669672012329215 0, 84.05480194091791 23.681146621704045 0, 84.0551223754884 23.684823989868164 0, 84.05212402343744 23.69135093688959 0, 84.03816986083996 23.705907821655273 0, 84.00990295410162 23.720376968383846 0, 83.99681091308588 23.720811843872184 0, 83.98747253417963 23.72953033447277 0, 83.98703002929699 23.734516143798885 0, 83.99004364013678 23.741531372070426 0, 83.99665069580078 23.751399993896428 0, 84.00585174560553 23.773727416992244 0, 84.01190185546875 23.784807205200252 0, 84.02265167236334 23.79897117614746 0))",both
HAZARIBAGH,1734005,891179,842826,403,"POLYGON Z ((85.33301544189459 24.28692626953125 0, 85.34540557861334 24.285022735595817 0, 85.36343383789057 24.285959243774528 0, 85.3713150024414 24.289278030395508 0, 85.380111694336 24.297815322875977 0, 85.3841171264649 24.309469223022518 0, 85.39217376708996 24.32171821594244 0, 85.40039062500011 24.328340530395508 0, 85.40895080566412 24.338174819946346 0, 85.41178894042974 24.338811874389705 0, 85.42056274414068 24.336845397949162 0, 85.43846893310553 24.329854965210018 0, 85.45940399169922 24.325519561767578 0, 85.46702575683594 24.325309753418026 0, 85.49112701416021 24.324203491210994 0, 85.5114974975586 24.32098579406744 0, 85.51922607421886 24.318313598632926 0, 85.53446197509777 24.321727752685547 0, 85.54647827148449 24.33235168457037 0, 85.55548095703136 24.33820152282715 0, 85.56780242919928 24.337017059326172 0, 85.58579254150402 24.329914093017578 0, 85.6048202514649 24.318717956543082 0, 85.61633300781261 24.312860488891545 0, 85.62504577636724 24.30747222900385 0, 85.61788177490234 24.299995422363395 0, 85.60543060302746 24.29114151000988 0, 85.59935760498058 24.28095054626465 0, 85.5743026733399 24.252466201782227 0, 85.55594635009766 24.240360260009822 0, 85.54145050048828 24.23172378540039 0, 85.52093505859386 24.21716690063471 0, 85.51548767089844 24.209529876708928 0, 85.51190948486334 24.196481704712028 0, 85.50623321533214 24.19101524353033 0, 85.49446105957026 24.18061256408697 0, 85.48992156982422 24.17543029785162 0, 85.489242553711 24.171308517456055 0, 85.491455078125 24.16431808471691 0, 85.49908447265625 24.161741256713867 0, 85.5158920288086 24.160217285156364 0, 85.5288925170899 24.156707763671932 0, 85.5374603271485 24.15040969848627 0, 85.55623626708996 24.137571334838924 0, 85.5696868896485 24.12906265258789 0, 85.57948303222668 24.123546600341797 0, 85.58402252197271 24.124025344848746 0, 85.59198760986328 24.120141983032283 0, 85.60330200195318 24.11705589294445 0, 85.60943603515636 24.117292404174805 0, 85.61501312255854 24.11616706848156 0, 85.62893676757807 24.110958099365234 0, 85.64220428466803 24.102169036865234 0, 85.65986633300781 24.090467453002987 0, 85.6735305786134 24.083879470825252 0, 85.68462371826166 24.080429077148494 0, 85.69773101806652 24.08178520202631 0, 85.70779418945318 24.082332611083984 0, 85.7158660888673 24.087837219238338 0, 85.7281723022461 24.100639343261776 0, 85.72820281982428 24.100612640380973 0, 85.73087310791021 24.10032653808605 0, 85.73367309570312 24.10293197631836 0, 85.73850250244146 24.10572433471691 0, 85.74543762207043 24.105941772460938 0, 85.75491333007818 24.10366630554205 0, 85.7591400146485 24.105440139770565 0, 85.76338958740246 24.10906791687006 0, 85.77071380615234 24.106943130493164 0, 85.76553344726562 24.09650611877447 0, 85.777816772461 24.08985710144043 0, 85.79040527343756 24.084819793701172 0, 85.79740142822266 24.08286094665533 0, 85.79322052001953 24.074132919311637 0, 85.79560852050793 24.072378158569393 0, 85.80344390869152 24.07063484191889 0, 85.80770874023438 24.07065773010254 0, 85.81587219238281 24.077779769897404 0, 85.81821441650396 24.078807830810604 0, 85.8227005004884 24.077545166015682 0, 85.82853698730474 24.07428359985363 0, 85.83207702636719 24.071405410766545 0, 85.83271789550787 24.068082809448242 0, 85.836669921875 24.066289901733512 0, 85.83850097656261 24.06615257263178 0, 85.84313201904291 24.069065093994197 0, 85.84570312500006 24.067169189453125 0, 85.84270477294933 24.063180923462028 0, 85.8443374633789 24.06129074096691 0, 85.8480072021485 24.059429168701115 0, 85.84826660156261 24.056612014770565 0, 85.85518646240234 24.05368614196783 0, 85.85863494873047 24.054031372070312 0, 85.86351013183605 24.05665397644043 0, 85.86566162109375 24.05449867248541 0, 85.8636322021485 24.051168441772518 0, 85.86618804931652 24.049631118774528 0, 85.86821746826178 24.050481796264762 0, 85.87126922607428 24.04649925231928 0, 85.87062072753906 24.04275703430187 0, 85.87206268310558 24.038953781127987 0, 85.87471008300787 24.03834342956543 0, 85.876953125 24.038894653320426 0, 85.8791122436524 24.03486061096197 0, 85.88941955566418 24.03453445434576 0, 85.88960266113287 24.032173156738338 0, 85.88213348388678 24.026401519775504 0, 85.88121795654308 24.020788192749023 0, 85.884994506836 24.01979064941412 0, 85.8892211914063 24.017360687255916 0, 85.89329528808588 24.01267051696783 0, 85.89427947998047 24.00394058227539 0, 85.8962860107423 23.992134094238338 0, 85.89997863769531 23.988513946533203 0, 85.90403747558594 23.988134384155217 0, 85.91151428222662 23.985170364379996 0, 85.91365051269543 23.982030868530217 0, 85.91835784912115 23.981533050537166 0, 85.9198226928711 23.97825241088873 0, 85.92479705810547 23.978872299194393 0, 85.93216705322277 23.969911575317496 0, 85.9315872192384 23.963111877441463 0, 85.9273300170899 23.955888748169002 0, 85.92114257812494 23.956737518310604 0, 85.91747283935558 23.956342697143555 0, 85.91299438476562 23.95585823059082 0, 85.9114761352539 23.95404624938965 0, 85.91220092773438 23.945892333984375 0, 85.90532684326172 23.949237823486328 0, 85.9013061523437 23.9533367156983 0, 85.89843749999994 23.954175949096793 0, 85.89538574218744 23.952964782714844 0, 85.89132690429699 23.954980850219783 0, 85.88793182373058 23.953704833984375 0, 85.88545989990246 23.949962615966797 0, 85.88228607177734 23.941974639892578 0, 85.88323211669922 23.93875503540039 0, 85.88520812988287 23.936134338378906 0, 85.88638305664074 23.93134117126465 0, 85.88605499267578 23.926881790161133 0, 85.88375854492182 23.92112922668457 0, 85.8833999633789 23.91757202148449 0, 85.88418579101562 23.914329528808707 0, 85.88901519775396 23.911994934082088 0, 85.88814544677729 23.90709877014166 0, 85.88837432861328 23.901813507080135 0, 85.88628387451172 23.896478652954215 0, 85.88186645507812 23.89219665527355 0, 85.87882995605469 23.886156082153434 0, 85.87234497070312 23.877725601196346 0, 85.86976623535162 23.873195648193416 0, 85.8681640625 23.869300842285213 0, 85.86592102050787 23.866271972656364 0, 85.86625671386719 23.86170387268072 0, 85.8648147583009 23.85801124572754 0, 85.86444091796886 23.854610443115234 0, 85.86190795898443 23.85087203979498 0, 85.84552764892584 23.840854644775334 0, 85.84147644042969 23.83737373352045 0, 85.83629608154297 23.830080032348746 0, 85.83180236816412 23.83262443542486 0, 85.82858276367199 23.832372665405273 0, 85.81446838378918 23.8342342376709 0, 85.81559753417974 23.839302062988338 0, 85.81356811523432 23.842144012451286 0, 85.80546569824224 23.84683990478527 0, 85.8055572509765 23.857200622558594 0, 85.8072662353515 23.860004425048885 0, 85.80414581298834 23.861675262451172 0, 85.80294036865234 23.864110946655387 0, 85.80362701416027 23.86646842956543 0, 85.80203247070318 23.869108200073356 0, 85.79962158203136 23.87110137939453 0, 85.79866027832043 23.874366760253906 0, 85.8015518188476 23.87975883483898 0, 85.79983520507807 23.881908416748047 0, 85.78998565673834 23.884023666381836 0, 85.78661346435558 23.886844635009766 0, 85.78459167480469 23.89743232727062 0, 85.78437805175776 23.900873184204045 0, 85.77701568603521 23.900999069213867 0, 85.77013397216797 23.905487060546932 0, 85.76546478271496 23.910844802856445 0, 85.76770782470709 23.924247741699332 0, 85.76546478271496 23.927093505859432 0, 85.75090026855474 23.929098129272518 0, 85.74758911132812 23.930948257446346 0, 85.7451400756836 23.934427261352653 0, 85.74198150634777 23.933490753173942 0, 85.74029541015636 23.930629730224723 0, 85.74203491210932 23.92713356018072 0, 85.73212432861322 23.922639846801758 0, 85.72547912597656 23.915884017944336 0, 85.72309875488293 23.912265777587947 0, 85.72281646728516 23.90839576721197 0, 85.72127532958984 23.904510498046875 0, 85.7177124023438 23.906124114990234 0, 85.71715545654303 23.912107467651367 0, 85.7157135009765 23.916896820068473 0, 85.70996856689464 23.916242599487248 0, 85.7023162841798 23.92202949523937 0, 85.686264038086 23.944549560546875 0, 85.68544006347656 23.949569702148494 0, 85.6897964477539 23.95640373229986 0, 85.69306945800781 23.95818519592291 0, 85.69825744628912 23.957487106323242 0, 85.69935607910156 23.961395263671932 0, 85.69730377197271 23.963359832763672 0, 85.68942260742188 23.967086791992188 0, 85.6826629638673 23.965904235839844 0, 85.67961883544933 23.96644783020031 0, 85.67707061767584 23.969087600708065 0, 85.67545318603527 23.966693878173942 0, 85.6742553710938 23.960054397583008 0, 85.6671371459961 23.95912933349615 0, 85.6664505004884 23.958326339721737 0, 85.67027282714855 23.95530509948742 0, 85.67240142822277 23.951929092407283 0, 85.66958618164062 23.943569183349666 0, 85.66456604003918 23.941303253173885 0, 85.65920257568371 23.93998527526861 0, 85.6473846435548 23.940921783447322 0, 85.64472961425793 23.936679840087947 0, 85.64502716064459 23.932594299316463 0, 85.64758300781261 23.93013000488287 0, 85.65468597412104 23.926883697509766 0, 85.65491485595703 23.922521591186467 0, 85.65809631347668 23.9205837249757 0, 85.65957641601568 23.918678283691463 0, 85.65680694580078 23.91654396057129 0, 85.64972686767572 23.91325759887701 0, 85.6471786499024 23.909358978271484 0, 85.63744354248053 23.905618667602653 0, 85.63230133056646 23.902637481689396 0, 85.62060546875 23.894762039184684 0, 85.61287689208996 23.88768768310547 0, 85.61069488525396 23.87887573242199 0, 85.6107025146485 23.873569488525447 0, 85.61300659179693 23.870025634765682 0, 85.61637878417969 23.862007141113338 0, 85.61511993408209 23.856224060058594 0, 85.61280822753912 23.854518890380916 0, 85.59148406982428 23.84724617004406 0, 85.58734893798822 23.84516143798828 0, 85.58393859863281 23.841434478759766 0, 85.58110809326172 23.8356609344483 0, 85.59008026123047 23.83212661743164 0, 85.59049224853521 23.828874588012752 0, 85.59609222412121 23.81847381591797 0, 85.5969467163086 23.81512641906744 0, 85.59273529052734 23.80873298645031 0, 85.59515380859386 23.800432205200195 0, 85.59816741943371 23.79632568359375 0, 85.60150909423828 23.794460296630973 0, 85.60287475585943 23.7909393310548 0, 85.60634613037115 23.789825439453068 0, 85.60806274414068 23.788320541381836 0, 85.61058807373058 23.78082466125494 0, 85.61569976806646 23.77918624877941 0, 85.6194686889649 23.779685974121207 0, 85.62458038330078 23.783607482910213 0, 85.63259887695312 23.787149429321403 0, 85.63514709472662 23.789907455444393 0, 85.63913726806646 23.80555343627924 0, 85.64417266845714 23.805526733398438 0, 85.64900207519531 23.80663681030279 0, 85.6514129638673 23.805391311645508 0, 85.65281677246094 23.79693984985363 0, 85.64853668212902 23.790990829467773 0, 85.64881896972656 23.781568527221623 0, 85.64745330810547 23.773641586303768 0, 85.63994598388683 23.7690486907959 0, 85.63603973388672 23.7642879486084 0, 85.63198852539057 23.760782241821346 0, 85.63063812255871 23.75764656066889 0, 85.62790679931646 23.754468917846793 0, 85.61445617675781 23.749832153320312 0, 85.61438751220714 23.73217582702631 0, 85.61870574951178 23.72740173339855 0, 85.61990356445318 23.71625518798828 0, 85.61956787109386 23.706212997436637 0, 85.61810302734375 23.69635581970215 0, 85.61600494384766 23.69340324401867 0, 85.60842132568365 23.68694877624523 0, 85.60856628417969 23.684181213378906 0, 85.61620330810547 23.67495727539074 0, 85.61625671386724 23.67038726806652 0, 85.61370849609375 23.66753578186041 0, 85.6144409179687 23.658105850219727 0, 85.61289215087902 23.6227703094483 0, 85.61389923095703 23.61627960205078 0, 85.61729431152338 23.616016387939453 0, 85.6208114624024 23.61476325988781 0, 85.62453460693371 23.612003326416016 0, 85.63001251220709 23.60491752624523 0, 85.63224792480474 23.600545883178825 0, 85.6358413696289 23.598239898681584 0, 85.64327239990234 23.595159530639705 0, 85.64642333984386 23.592903137207088 0, 85.6531448364259 23.591379165649414 0, 85.66167449951178 23.601381301879996 0, 85.6640090942384 23.60559844970703 0, 85.66399383544933 23.608398437500114 0, 85.66263580322277 23.61151885986328 0, 85.66411590576178 23.614191055297965 0, 85.6675643920899 23.613767623901367 0, 85.66967773437506 23.615530014038143 0, 85.66897583007824 23.61778640747076 0, 85.67201232910168 23.62034034729004 0, 85.67682647705078 23.621135711669922 0, 85.67794036865246 23.62391853332531 0, 85.6770858764649 23.627338409423885 0, 85.67823791503912 23.630773544311523 0, 85.68192291259777 23.631999969482365 0, 85.68545532226562 23.629613876342773 0, 85.69032287597668 23.625976562499943 0, 85.69792938232433 23.62994956970209 0, 85.70063781738293 23.62905311584484 0, 85.70294952392578 23.623804092407227 0, 85.70938873291027 23.618700027465877 0, 85.71215057373047 23.61827278137207 0, 85.71701812744152 23.620458602905273 0, 85.7216033935548 23.626821517944393 0, 85.72620391845697 23.63801383972168 0, 85.72981262207043 23.640357971191406 0, 85.73451995849615 23.639690399169922 0, 85.73889160156256 23.640659332275447 0, 85.74974822998053 23.648159027099723 0, 85.75376129150396 23.656036376953182 0, 85.75624084472662 23.667482376098633 0, 85.7588882446289 23.673450469970703 0, 85.7620849609375 23.6739444732666 0, 85.76593017578125 23.67164611816412 0, 85.76904296875006 23.666604995727653 0, 85.77128601074219 23.660774230957088 0, 85.77168273925787 23.657255172729492 0, 85.76968383789074 23.640428543090877 0, 85.7726669311524 23.63578605651861 0, 85.7798919677735 23.633747100830078 0, 85.7821655273438 23.631433486938477 0, 85.7835083007813 23.62703323364252 0, 85.79132843017584 23.622024536132812 0, 85.78723907470697 23.61545562744152 0, 85.79213714599615 23.61361122131359 0, 85.79100799560558 23.606048583984432 0, 85.79537963867193 23.608198165893498 0, 85.79613494873053 23.60769844055187 0, 85.79843139648443 23.60216140747076 0, 85.80200958251959 23.60017395019537 0, 85.80456542968761 23.594087600708065 0, 85.80779266357433 23.590017318725643 0, 85.80867004394531 23.5806827545166 0, 85.81332397460949 23.563230514526367 0, 85.81720733642578 23.562782287597713 0, 85.82114410400402 23.563549041748047 0, 85.82428741455078 23.561565399170036 0, 85.83291625976568 23.562234878540096 0, 85.83886718750006 23.554290771484375 0, 85.84058380126959 23.550056457519645 0, 85.83815002441418 23.549592971801758 0, 85.8360824584961 23.542755126953182 0, 85.8245239257813 23.539350509643498 0, 85.82142639160156 23.535808563232536 0, 85.82889556884771 23.525413513183707 0, 85.8330307006836 23.524894714355412 0, 85.83944702148449 23.521554946899414 0, 85.84060668945324 23.51831436157221 0, 85.83723449707031 23.511184692382812 0, 85.83651733398438 23.507251739501896 0, 85.83717346191418 23.5040740966798 0, 85.84015655517584 23.50157737731928 0, 85.846435546875 23.500579833984432 0, 85.85084533691412 23.500762939453182 0, 85.85420989990234 23.502040863037166 0, 85.85869598388678 23.504756927490348 0, 85.8615112304688 23.50473976135254 0, 85.86544799804682 23.50350952148449 0, 85.86756896972656 23.50098609924322 0, 85.8678588867188 23.499061584472713 0, 85.87525939941412 23.49758529663086 0, 85.87615203857422 23.49493026733404 0, 85.88079071044928 23.492691040039062 0, 85.88158416748053 23.490745544433537 0, 85.88353729248058 23.49026298522955 0, 85.88443756103521 23.48895072937023 0, 85.88304138183594 23.48667335510254 0, 85.88711547851568 23.48521804809576 0, 85.88701629638672 23.483247756958065 0, 85.88153076171875 23.47825813293457 0, 85.87808227539062 23.478630065918026 0, 85.87403106689447 23.477203369140568 0, 85.86997985839855 23.472635269165153 0, 85.8675003051759 23.461910247802734 0, 85.86601257324213 23.457399368286246 0, 85.86350250244152 23.453380584716854 0, 85.86370849609386 23.444065093994254 0, 85.86483001708996 23.43064117431652 0, 85.8575897216798 23.42423820495611 0, 85.85433959960949 23.424907684326172 0, 85.8495559692384 23.42851066589367 0, 85.84725952148443 23.427345275878963 0, 85.84811401367188 23.422910690307674 0, 85.84389495849604 23.421276092529297 0, 85.84069061279297 23.428514480590877 0, 85.8373489379884 23.432531356811467 0, 85.82766723632824 23.43880844116211 0, 85.8283309936524 23.44670486450201 0, 85.82492828369146 23.450778961181754 0, 85.82071685791021 23.452938079833984 0, 85.81445312500006 23.45433807373047 0, 85.80322265625011 23.45427894592291 0, 85.80051422119146 23.449876785278377 0, 85.79639434814447 23.449916839599666 0, 85.79290771484386 23.455133438110295 0, 85.78916931152344 23.45448112487793 0, 85.78016662597668 23.455347061157227 0, 85.77676391601562 23.458950042724723 0, 85.77156829833996 23.459384918212834 0, 85.76914978027344 23.458559036254826 0, 85.75650787353527 23.460557937622127 0, 85.74748229980474 23.458364486694393 0, 85.74484252929699 23.45362091064453 0, 85.73939514160156 23.450307846069336 0, 85.73459625244135 23.44872474670416 0, 85.73146820068365 23.45002365112299 0, 85.72917938232428 23.45352554321289 0, 85.72293853759777 23.447662353515625 0, 85.72006225585949 23.442399978637695 0, 85.71682739257824 23.441631317138615 0, 85.71250915527344 23.442296981811523 0, 85.70899200439464 23.44434547424322 0, 85.7049179077149 23.445529937744197 0, 85.68303680419928 23.448778152465877 0, 85.67294311523449 23.451471328735465 0, 85.6710662841798 23.457395553588867 0, 85.66072082519537 23.461814880371094 0, 85.65724945068365 23.465129852294922 0, 85.64237976074224 23.465551376342773 0, 85.63643646240234 23.466825485229606 0, 85.63027954101562 23.469264984130973 0, 85.62561798095709 23.472803115844783 0, 85.61136627197277 23.478981018066406 0, 85.60527801513666 23.482383728027344 0, 85.6044311523438 23.48975563049322 0, 85.59590148925793 23.49251747131342 0, 85.59098815917969 23.495647430419922 0, 85.58683776855469 23.503683090209904 0, 85.57621002197271 23.509773254394645 0, 85.5687026977539 23.515300750732422 0, 85.54911041259771 23.538545608520508 0, 85.54439544677746 23.540229797363338 0, 85.53809356689464 23.539840698242188 0, 85.5334243774414 23.538135528564567 0, 85.5306243896485 23.532754898071232 0, 85.52817535400402 23.53318977355957 0, 85.5224990844726 23.537179946899414 0, 85.51823425292974 23.54337692260748 0, 85.52657318115234 23.561523437499943 0, 85.52557373046875 23.565729141235465 0, 85.52307891845697 23.57025337219244 0, 85.52258300781256 23.575672149658317 0, 85.52029418945318 23.577493667602596 0, 85.51518249511724 23.576820373535156 0, 85.51136016845709 23.572761535644474 0, 85.50345611572266 23.570676803588867 0, 85.50423431396484 23.56774711608898 0, 85.50936889648438 23.562721252441406 0, 85.5129013061524 23.554792404174748 0, 85.5137176513673 23.54512214660656 0, 85.50862884521484 23.541801452636776 0, 85.50009918212896 23.544841766357422 0, 85.49198913574213 23.54402351379389 0, 85.48586273193371 23.549167633056754 0, 85.48148345947277 23.554546356201115 0, 85.48596954345709 23.56028175354004 0, 85.48623657226574 23.563398361206055 0, 85.47050476074224 23.57191848754877 0, 85.46834564208984 23.56872367858881 0, 85.47007751464844 23.565462112426815 0, 85.46936798095709 23.558015823364315 0, 85.46140289306646 23.555183410644645 0, 85.45042419433594 23.54991531372076 0, 85.44398498535156 23.549858093261832 0, 85.42617034912121 23.554725646972713 0, 85.4178466796875 23.56007003784191 0, 85.4119491577149 23.561574935913143 0, 85.40827178955078 23.55687522888195 0, 85.4027252197265 23.555793762206974 0, 85.39752197265636 23.556379318237305 0, 85.3924331665039 23.55812263488764 0, 85.38925933837896 23.562246322631836 0, 85.38587188720709 23.558702468872013 0, 85.3836669921875 23.550672531127987 0, 85.36761474609386 23.559410095214787 0, 85.36369323730474 23.56243324279791 0, 85.34777069091808 23.56199836730957 0, 85.33780670166021 23.559150695800838 0, 85.33398437500006 23.560091018676758 0, 85.32386779785162 23.56836128234869 0, 85.31876373291027 23.570333480835018 0, 85.30867767333996 23.573011398315487 0, 85.29565429687506 23.574277877807617 0, 85.27913665771484 23.579431533813533 0, 85.27098846435547 23.580915451049748 0, 85.26618194580078 23.58075904846197 0, 85.2646713256836 23.581777572631893 0, 85.26393127441406 23.584712982177734 0, 85.26182556152344 23.58763122558605 0, 85.2421264648437 23.596736907958984 0, 85.24272155761719 23.603319168090934 0, 85.23839569091803 23.611581802368164 0, 85.23437500000006 23.61678695678711 0, 85.23419952392584 23.620132446289062 0, 85.23033905029297 23.619461059570426 0, 85.21213531494152 23.619935989379826 0, 85.20690917968756 23.622541427612305 0, 85.20217895507818 23.633859634399357 0, 85.20201873779308 23.639619827270508 0, 85.20339202880871 23.64395713806158 0, 85.20953369140625 23.651281356811637 0, 85.21177673339855 23.655847549438477 0, 85.21990203857428 23.65551948547369 0, 85.21885681152338 23.659023284912223 0, 85.22095489501947 23.660886764526367 0, 85.21942901611322 23.666517257690543 0, 85.22285461425776 23.675601959228572 0, 85.2260360717774 23.67637252807623 0, 85.23543548583996 23.683313369750977 0, 85.23583221435541 23.68625068664562 0, 85.2340545654298 23.687273025512695 0, 85.22796630859386 23.68498039245611 0, 85.2238159179687 23.68620872497553 0, 85.22118377685547 23.690448760986385 0, 85.22436523437511 23.699405670166072 0, 85.22309112548828 23.700832366943473 0, 85.2162704467774 23.701244354248047 0, 85.19682312011724 23.708448410034237 0, 85.18665313720703 23.71031951904297 0, 85.17887115478521 23.69251060485834 0, 85.17235565185547 23.685314178466854 0, 85.17100524902344 23.679191589355412 0, 85.16350555419933 23.66696548461914 0, 85.15586853027355 23.6749725341798 0, 85.15209960937494 23.67251777648937 0, 85.12702178955084 23.66837120056158 0, 85.12265777587896 23.666601181030273 0, 85.11859130859375 23.66695785522461 0, 85.10536956787104 23.66451072692871 0, 85.09767913818371 23.668149948120117 0, 85.08276367187506 23.67015266418457 0, 85.07564544677734 23.669393539428825 0, 85.07719421386719 23.673433303833065 0, 85.07015991210943 23.679313659668026 0, 85.0629501342774 23.68379783630371 0, 85.05722808837896 23.689252853393498 0, 85.05615997314447 23.69304084777832 0, 85.05934143066418 23.69805335998541 0, 85.06504058837896 23.69757080078125 0, 85.06932067871088 23.69972229003912 0, 85.06798553466791 23.704410552978572 0, 85.06835937499994 23.708326339721623 0, 85.06629943847656 23.712034225463924 0, 85.05610656738293 23.709798812866268 0, 85.05358123779303 23.712118148803825 0, 85.05297088623047 23.714534759521598 0, 85.05342102050787 23.726129531860465 0, 85.05786895751947 23.737499237060547 0, 85.05742645263678 23.74912452697754 0, 85.05621337890625 23.75911521911621 0, 85.05067443847656 23.77441787719738 0, 85.04845428466803 23.781024932861328 0, 85.04823303222662 23.782968521118278 0, 85.05070495605474 23.787309646606502 0, 85.05046844482422 23.791555404663086 0, 85.04778289794922 23.797264099121037 0, 85.0436401367188 23.801454544067496 0, 85.04312896728527 23.806171417236328 0, 85.04703521728516 23.808898925781193 0, 85.05341339111334 23.815690994262695 0, 85.0541610717774 23.819444656372013 0, 85.05376434326178 23.824802398681754 0, 85.05089569091803 23.829523086547965 0, 85.04764556884771 23.834861755371094 0, 85.04071807861328 23.84725379943859 0, 85.03839111328136 23.85713005065918 0, 85.03689575195307 23.861818313598633 0, 85.03453826904303 23.868648529052848 0, 85.02930450439453 23.88098335266119 0, 85.0264663696289 23.892963409423828 0, 85.02689361572271 23.896358489990178 0, 85.03301239013678 23.90150070190424 0, 85.04219055175793 23.905622482299805 0, 85.0449829101563 23.907833099365234 0, 85.05344390869152 23.919164657592773 0, 85.05561065673828 23.92600250244135 0, 85.05475616455084 23.929718017578182 0, 85.05269622802746 23.9334716796875 0, 85.04267883300781 23.943937301635742 0, 85.03813934326178 23.96289443969738 0, 85.03550720214855 23.973472595214957 0, 85.036376953125 23.980354309082145 0, 85.03968048095709 23.985313415527457 0, 85.04175567626959 23.98718070983881 0, 85.04360961914062 23.988409042358455 0, 85.04659271240246 23.987665176391545 0, 85.05677032470703 23.973508834838867 0, 85.06033325195324 23.969799041748047 0, 85.06406402587896 23.967741012573185 0, 85.06719970703136 23.968557357788086 0, 85.07132720947271 23.968975067138786 0, 85.07577514648449 23.96726036071783 0, 85.0782852172851 23.96478271484375 0, 85.07913208007818 23.95821189880371 0, 85.07837677001959 23.951879501342887 0, 85.07987213134766 23.946393966674805 0, 85.08312225341803 23.944995880126896 0, 85.08773803710943 23.94769859313959 0, 85.0916748046875 23.94830513000494 0, 85.09880065917974 23.938301086425838 0, 85.10295104980469 23.93420028686529 0, 85.10629272460949 23.932466506958065 0, 85.11378479003906 23.92932510375988 0, 85.12560272216797 23.92902183532709 0, 85.14199829101562 23.93121337890625 0, 85.14855957031256 23.93329620361328 0, 85.15892791748058 23.937763214111328 0, 85.1731796264649 23.949991226196346 0, 85.205795288086 23.983816146850586 0, 85.21994781494152 24.004066467285156 0, 85.22561645507818 24.015390396118164 0, 85.23002624511724 24.027587890625057 0, 85.2311401367188 24.041511535644588 0, 85.23078918457037 24.04645156860346 0, 85.21121215820324 24.059055328369084 0, 85.20789337158209 24.060867309570256 0, 85.19953918457043 24.06795692443842 0, 85.18504333496105 24.081727981567383 0, 85.17937469482416 24.087909698486328 0, 85.17560577392578 24.094209671020565 0, 85.17263031005865 24.09660148620611 0, 85.16603088378906 24.103101730346793 0, 85.16437530517584 24.106935501098633 0, 85.16201019287104 24.115285873413143 0, 85.15812683105474 24.134050369262752 0, 85.1575317382813 24.13416290283203 0, 85.15326690673828 24.14803504943859 0, 85.1512298583985 24.150777816772518 0, 85.14635467529308 24.15797615051281 0, 85.14225769042974 24.16674041748047 0, 85.14149475097662 24.172754287719783 0, 85.14506530761719 24.176597595214957 0, 85.14544677734375 24.193147659301758 0, 85.14470672607422 24.201637268066406 0, 85.14446258544916 24.209419250488395 0, 85.14918518066418 24.214420318603572 0, 85.16235351562511 24.219690322876033 0, 85.17060089111322 24.219964981079215 0, 85.18379974365234 24.21841621398937 0, 85.1943817138673 24.216674804687614 0, 85.21277618408203 24.215412139892692 0, 85.22207641601574 24.213432312011832 0, 85.23541259765636 24.209217071533203 0, 85.26642608642584 24.199571609497013 0, 85.2715682983399 24.197643280029354 0, 85.2858657836914 24.186187744140625 0, 85.28895568847662 24.185619354248104 0, 85.29194641113281 24.187452316284123 0, 85.29193878173828 24.199615478515682 0, 85.28828430175776 24.210889816284293 0, 85.28831481933594 24.216602325439396 0, 85.29262542724621 24.223640441894588 0, 85.30175781250006 24.230697631835994 0, 85.3093948364259 24.2405681610108 0, 85.31099700927734 24.245212554931584 0, 85.31217956542969 24.262224197387752 0, 85.31628417968761 24.27856826782238 0, 85.322494506836 24.282960891723633 0, 85.33301544189459 24.28692626953125 0))",both
RAMGARH,949159,494037,455122,684,,left_only
DUMKA,1321096,669240,651856,300,"POLYGON Z ((86.91474151611328 24.540142059326172 0, 86.91072082519531 24.54483985900879 0, 86.9098587036134 24.550718307495174 0, 86.91007232666027 24.556734085083065 0, 86.91001129150396 24.5613250732423 0, 86.9099349975586 24.56481170654297 0, 86.90479278564453 24.56821823120123 0, 86.90679931640636 24.572952270507926 0, 86.90424346923828 24.577566146850586 0, 86.90155029296875 24.581945419311523 0, 86.90167236328136 24.587947845458928 0, 86.90483093261724 24.592979431152457 0, 86.90827178955084 24.59654426574707 0, 86.9125442504884 24.598390579223576 0, 86.91361999511724 24.602539062499943 0, 86.92145538330084 24.61218070983898 0, 86.92255401611328 24.614864349365234 0, 86.92253112792969 24.620788574218807 0, 86.92745971679682 24.62570762634283 0, 86.93285369873047 24.627807617187557 0, 86.93772888183605 24.627902984619197 0, 86.9396438598634 24.63173866271984 0, 86.93704223632812 24.637083053588867 0, 86.93370056152355 24.644180297851562 0, 86.94243621826178 24.644433975219727 0, 86.9522171020509 24.644119262695256 0, 86.95112609863281 24.63723754882824 0, 86.9483261108399 24.632545471191406 0, 86.94906616210938 24.627944946289062 0, 86.95706176757812 24.62904930114746 0, 86.96199798583984 24.630817413330192 0, 86.96912384033209 24.633249282837028 0, 86.97476196289057 24.631685256958065 0, 86.98365020751959 24.626064300537223 0, 86.98904418945324 24.62303352355957 0, 86.99168395996105 24.62160301208496 0, 86.99362182617199 24.621429443359318 0, 86.99366760253906 24.62211799621582 0, 86.99613952636719 24.62058448791504 0, 87.01370239257812 24.60768699645996 0, 87.01642608642584 24.6105194091798 0, 87.01911163330084 24.614725112915096 0, 87.02020263671875 24.61921310424816 0, 87.02494812011719 24.62103843688965 0, 87.02784729003906 24.62252807617199 0, 87.0298538208009 24.621494293213004 0, 87.0299682617188 24.6174640655517 0, 87.0299072265625 24.612657546997184 0, 87.03100585937511 24.610734939575252 0, 87.03361511230474 24.61095046997076 0, 87.03606414794928 24.61132431030279 0, 87.03844451904308 24.6115398406983 0, 87.03941345214838 24.613203048706055 0, 87.0401763916015 24.614662170410213 0, 87.04220581054693 24.613969802856502 0, 87.04433441162121 24.61248016357422 0, 87.04647064208979 24.610366821289006 0, 87.04809570312506 24.606838226318303 0, 87.0539321899414 24.6082057952882 0, 87.05181121826166 24.611581802368164 0, 87.05020141601568 24.615633010864258 0, 87.05020141601568 24.61882209777832 0, 87.04940032958984 24.62159156799322 0, 87.0478744506836 24.62544822692871 0, 87.05335235595703 24.627302169799748 0, 87.05548095703125 24.63428878784191 0, 87.05850219726562 24.639738082885742 0, 87.06285095214855 24.642892837524414 0, 87.06861877441406 24.642564773559627 0, 87.07518768310553 24.639768600463924 0, 87.07981109619152 24.637414932251033 0, 87.0857925415039 24.63768768310547 0, 87.0899887084961 24.638231277465934 0, 87.0958099365235 24.635282516479606 0, 87.10028839111328 24.63267517089838 0, 87.10629272460943 24.630689620971793 0, 87.11003875732422 24.62979125976574 0, 87.11709594726562 24.6294841766358 0, 87.12116241455084 24.628564834594727 0, 87.12560272216808 24.628555297851562 0, 87.12965393066406 24.629011154174748 0, 87.13383483886713 24.62674331665039 0, 87.13790893554693 24.622968673706055 0, 87.143295288086 24.619453430175838 0, 87.14863586425787 24.616630554199332 0, 87.15372467041016 24.61438751220703 0, 87.15876770019543 24.61394309997553 0, 87.16358184814447 24.615116119384822 0, 87.1693954467774 24.615409851074276 0, 87.17324066162115 24.61203002929699 0, 87.17668914794933 24.60832023620611 0, 87.18000030517578 24.606569290161246 0, 87.18580627441412 24.607442855835075 0, 87.18954467773438 24.60511398315424 0, 87.19406127929699 24.601490020751896 0, 87.19914245605474 24.596996307373104 0, 87.20450592041021 24.594171524047965 0, 87.20743560791027 24.59359169006359 0, 87.20992279052746 24.592100143432674 0, 87.21251678466803 24.589330673217717 0, 87.21695709228527 24.588148117065543 0, 87.22097015380871 24.590562820434684 0, 87.22339630126959 24.59277534484869 0, 87.22995758056635 24.59074783325201 0, 87.23483276367193 24.58932876586914 0, 87.24147033691406 24.58787918090826 0, 87.24665832519537 24.58621788024908 0, 87.25160217285162 24.58861923217779 0, 87.25691223144531 24.590143203735465 0, 87.26272583007824 24.5915470123291 0, 87.2679443359375 24.59475135803234 0, 87.27186584472668 24.599765777588004 0, 87.2753143310548 24.60282707214367 0, 87.27872467041021 24.6035213470459 0, 87.28215026855474 24.602067947387695 0, 87.28537750244146 24.600334167480526 0, 87.28904724121105 24.59808158874523 0, 87.29518127441418 24.596183776855526 0, 87.3004837036134 24.597705841064453 0, 87.3073120117188 24.596374511718807 0, 87.31191253662115 24.5970458984375 0, 87.31327056884777 24.592807769775447 0, 87.31428527832031 24.589555740356502 0, 87.31823730468761 24.586368560791072 0, 87.32290649414062 24.583398818969727 0, 87.32594299316406 24.58161544799816 0, 87.32868194580084 24.57971572875988 0, 87.33020782470709 24.57783889770502 0, 87.33042144775402 24.57506752014166 0, 87.33007812500011 24.570619583129883 0, 87.33140563964855 24.56730461120611 0, 87.33425140380871 24.564477920532227 0, 87.33821105957037 24.561355590820256 0, 87.34047698974615 24.56154441833496 0, 87.3437957763673 24.557788848877067 0, 87.34677886962896 24.552425384521598 0, 87.35033416748047 24.547344207763672 0, 87.35442352294928 24.544384002685604 0, 87.35724639892578 24.5409317016601 0, 87.3610610961914 24.536016464233455 0, 87.36563873291016 24.52854156494135 0, 87.36993408203136 24.523323059082088 0, 87.3729934692384 24.51883125305187 0, 87.37535858154297 24.513818740844783 0, 87.37569427490234 24.508380889892692 0, 87.3787078857423 24.504692077636662 0, 87.38577270507824 24.502849578857536 0, 87.39242553710949 24.502395629882926 0, 87.39775848388683 24.501960754394588 0, 87.40234375000011 24.50212287902832 0, 87.40318298339844 24.506467819213924 0, 87.41516113281244 24.506849288940487 0, 87.41694641113281 24.50832557678234 0, 87.42038726806646 24.511789321899528 0, 87.42369079589855 24.514511108398494 0, 87.42683410644531 24.514913558960075 0, 87.4297103881836 24.514528274536133 0, 87.43155670166027 24.515882492065543 0, 87.43458557128918 24.51761627197277 0, 87.43823242187511 24.517562866210994 0, 87.44336700439464 24.517013549804744 0, 87.44574737548828 24.517435073852596 0, 87.44837188720703 24.520401000976562 0, 87.45071411132818 24.521800994873047 0, 87.45527648925781 24.520460128784293 0, 87.45783996582043 24.520187377929688 0, 87.46302795410168 24.522470474243278 0, 87.46892547607433 24.523117065429744 0, 87.4754104614259 24.524682998657283 0, 87.47860717773443 24.52797889709484 0, 87.48207092285168 24.52890777587902 0, 87.48977661132812 24.52842903137207 0, 87.49781799316406 24.525699615478572 0, 87.50315856933594 24.52244186401373 0, 87.5099868774414 24.517885208129996 0, 87.5178833007813 24.514350891113338 0, 87.52613830566418 24.513233184814453 0, 87.5311508178711 24.509691238403434 0, 87.5348129272461 24.50754928588873 0, 87.53677368164068 24.508152008056697 0, 87.54068756103516 24.513391494750977 0, 87.54516601562506 24.518224716186523 0, 87.5547332763673 24.520654678344783 0, 87.56233215332037 24.521272659301815 0, 87.56607055664062 24.51607894897461 0, 87.56847381591808 24.50997543334961 0, 87.57178497314453 24.5056533813476 0, 87.56842803955084 24.50074386596691 0, 87.56712341308605 24.49373245239252 0, 87.56637573242199 24.487514495849666 0, 87.56469726562494 24.4777889251709 0, 87.56757354736328 24.470006942749023 0, 87.566879272461 24.455770492553825 0, 87.56707000732428 24.434589385986442 0, 87.56752777099621 24.418373107910213 0, 87.56996154785162 24.396631240844727 0, 87.5711822509765 24.380397796630973 0, 87.57520294189453 24.36700057983404 0, 87.57936859130871 24.351524353027457 0, 87.5819320678711 24.34029197692871 0, 87.585189819336 24.330423355102482 0, 87.58671569824224 24.32497787475586 0, 87.58555603027344 24.31559181213379 0, 87.58448791503918 24.305393218994197 0, 87.58393859863293 24.291904449463004 0, 87.58369445800787 24.281290054321346 0, 87.58355712890636 24.27050399780279 0, 87.5819702148438 24.258939743042106 0, 87.58626556396484 24.25793838500988 0, 87.59359741210943 24.25856399536127 0, 87.60170745849604 24.256574630737305 0, 87.60708618164062 24.25654411315918 0, 87.61520385742199 24.25882720947277 0, 87.6227645874024 24.258459091186523 0, 87.63282012939453 24.257131576538086 0, 87.64435577392584 24.251852035522518 0, 87.64266204833996 24.2480144500733 0, 87.63834381103516 24.24451637268072 0, 87.63919830322271 24.240171432495117 0, 87.64213562011713 24.23671913146984 0, 87.64561462402344 24.232103347778377 0, 87.645767211914 24.226613998413086 0, 87.64411926269537 24.22162437438965 0, 87.64105224609375 24.218162536621207 0, 87.64033508300787 24.213609695434627 0, 87.64772033691406 24.210020065307617 0, 87.65537261962896 24.208219528198356 0, 87.66159820556635 24.209434509277287 0, 87.668701171875 24.208150863647518 0, 87.67350769042974 24.207778930664062 0, 87.6763534545899 24.202531814575252 0, 87.67718505859386 24.197267532348746 0, 87.68086242675776 24.193168640136776 0, 87.68608093261724 24.191112518310604 0, 87.69145202636724 24.187202453613338 0, 87.69509887695318 24.188236236572266 0, 87.69651794433594 24.184055328369197 0, 87.69632720947266 24.18054008483898 0, 87.69920349121094 24.17742919921875 0, 87.69895172119152 24.173395156860465 0, 87.69898986816406 24.169300079345646 0, 87.69574737548828 24.16641807556158 0, 87.69615173339844 24.16127014160162 0, 87.69499969482422 24.156566619873047 0, 87.69210052490246 24.151947021484432 0, 87.68689727783209 24.151281356811523 0, 87.68268585205084 24.150093078613395 0, 87.67606353759777 24.153444290161133 0, 87.67031860351574 24.15354537963873 0, 87.66616821289057 24.156389236450252 0, 87.65950775146484 24.158008575439567 0, 87.65311431884771 24.1566219329834 0, 87.64835357666021 24.155893325805607 0, 87.64324188232433 24.157022476196403 0, 87.63890838623047 24.159467697143555 0, 87.63420867919928 24.162376403808594 0, 87.63013458251953 24.16521835327154 0, 87.624267578125 24.165948867797965 0, 87.61865234375011 24.166742324829215 0, 87.61302947998053 24.166957855224723 0, 87.60676574707037 24.166080474853516 0, 87.60220336914068 24.162588119506893 0, 87.59819030761724 24.161907196044922 0, 87.593002319336 24.16217041015625 0, 87.58670806884771 24.163543701171875 0, 87.58239746093761 24.163616180419922 0, 87.57934570312511 24.16096305847168 0, 87.57203674316412 24.157733917236385 0, 87.5740737915039 24.156490325927848 0, 87.57910919189459 24.15485191345209 0, 87.58350372314459 24.152526855468807 0, 87.58864593505865 24.149612426757812 0, 87.59265899658209 24.14619445800787 0, 87.59653472900402 24.143583297729435 0, 87.60054779052746 24.140056610107536 0, 87.60381317138672 24.137292861938533 0, 87.6075057983399 24.134227752685547 0, 87.6101913452149 24.13105964660656 0, 87.60739898681652 24.128692626953182 0, 87.60301208496105 24.12749671936035 0, 87.59799957275396 24.127006530761832 0, 87.59523010253906 24.126363754272518 0, 87.58433532714855 24.125524520874023 0, 87.58214569091803 24.12164115905773 0, 87.58225250244135 24.117141723632812 0, 87.58041381835943 24.1125545501709 0, 87.57745361328136 24.111103057861442 0, 87.57471466064459 24.111848831176758 0, 87.57184600830084 24.1088924407959 0, 87.57212066650402 24.103124618530387 0, 87.57326507568371 24.097618103027457 0, 87.57691192626947 24.09230613708496 0, 87.57904815673828 24.0892715454101 0, 87.57875823974621 24.087429046630973 0, 87.5757827758789 24.08846664428711 0, 87.57280731201178 24.089782714843807 0, 87.56934356689453 24.08857345581066 0, 87.5660629272461 24.086664199829045 0, 87.56234741210943 24.08505630493164 0, 87.5588989257813 24.08448219299322 0, 87.55525207519537 24.086679458618164 0, 87.55089569091803 24.087619781494254 0, 87.54684448242193 24.088724136352653 0, 87.5418090820312 24.089965820312557 0, 87.53712463378912 24.093563079833928 0, 87.53362274169922 24.097026824951172 0, 87.53333282470709 24.10135841369629 0, 87.53251647949219 24.104547500610465 0, 87.52959442138683 24.1059246063233 0, 87.52671813964855 24.105854034423885 0, 87.52397918701178 24.10636711120617 0, 87.52257537841797 24.108001708984375 0, 87.52156066894543 24.110849380493278 0, 87.51959991455084 24.113132476806697 0, 87.51634979248053 24.112953186035156 0, 87.51320648193354 24.112487792968807 0, 87.50985717773443 24.113409042358512 0, 87.50563049316406 24.11492347717285 0, 87.50222015380865 24.116703033447266 0, 87.49930572509766 24.11791610717779 0, 87.4962997436524 24.117332458496094 0, 87.4957962036134 24.11405181884777 0, 87.4965438842774 24.11028289794922 0, 87.49806213378912 24.107603073120117 0, 87.49925994873058 24.10481262207037 0, 87.49964141845714 24.101463317871207 0, 87.49852752685547 24.099292755126896 0, 87.49634552001959 24.099388122558537 0, 87.4955062866211 24.097612380981502 0, 87.49620819091808 24.09523963928217 0, 87.49234771728521 24.09218788146967 0, 87.49163055419933 24.090353012085075 0, 87.49269104003912 24.087623596191406 0, 87.49592590332037 24.086759567260685 0, 87.50067901611328 24.086507797241325 0, 87.50484466552734 24.0854549407959 0, 87.50845336914062 24.084247589111328 0, 87.50802612304699 24.08159828186041 0, 87.50624084472662 24.079839706421012 0, 87.50527191162115 24.077432632446346 0, 87.50392150878906 24.07549095153803 0, 87.50246429443371 24.074712753296012 0, 87.49954223632818 24.075859069824276 0, 87.49588775634766 24.076902389526367 0, 87.49241638183588 24.07539558410639 0, 87.49160766601574 24.071840286254883 0, 87.49341583251953 24.068752288818473 0, 87.4952011108399 24.06687355041504 0, 87.4969100952149 24.064830780029297 0, 87.49597930908214 24.061437606811523 0, 87.4945297241211 24.057720184326115 0, 87.49390411376964 24.054212570190487 0, 87.49805450439459 24.052173614501896 0, 87.50402069091808 24.049713134765682 0, 87.50691986083984 24.0483913421632 0, 87.51048278808605 24.047868728637752 0, 87.51111602783203 24.044748306274414 0, 87.51318359375011 24.04205703735363 0, 87.5116653442384 24.036897659301758 0, 87.50936126708996 24.03422355651861 0, 87.50658416748047 24.03230476379389 0, 87.50460052490246 24.03037643432623 0, 87.50393676757818 24.028316497802848 0, 87.50400543212902 24.024564743041935 0, 87.4991455078125 24.025394439697322 0, 87.49740600585938 24.026580810546875 0, 87.49389648437511 24.025600433349666 0, 87.49113464355469 24.02156257629406 0, 87.48908996582037 24.0181884765625 0, 87.48541259765625 24.015888214111442 0, 87.48181152343756 24.016357421875057 0, 87.47886657714838 24.015245437622127 0, 87.47611999511724 24.013675689697266 0, 87.47407531738293 24.01313209533697 0, 87.47191619873053 24.01379776000988 0, 87.47000885009771 24.014410018921012 0, 87.4666213989259 24.014863967895565 0, 87.46477508544922 24.015352249145508 0, 87.46195220947266 24.015222549438533 0, 87.45958709716808 24.016294479370174 0, 87.4576034545899 24.01719284057623 0, 87.4549407958985 24.017297744750977 0, 87.45122528076172 24.01857185363764 0, 87.44894409179688 24.016525268554744 0, 87.44585418701183 24.015998840332145 0, 87.44142913818371 24.01475334167486 0, 87.43920135498041 24.013174057006836 0, 87.43653106689447 24.010560989379826 0, 87.4373550415039 24.00910377502447 0, 87.43948364257818 24.010042190551758 0, 87.4411392211914 24.011281967163086 0, 87.44358825683588 24.011703491210938 0, 87.44692993164068 24.011344909668026 0, 87.44945526123058 24.010589599609432 0, 87.44880676269537 24.009212493896598 0, 87.44756317138683 24.008012771606502 0, 87.44517517089844 24.007545471191463 0, 87.44409942626964 24.005481719970703 0, 87.44600677490246 24.003185272216797 0, 87.44945526123058 24.002876281738224 0, 87.45288085937511 24.00224113464367 0, 87.453369140625 24.00149536132824 0, 87.4575424194336 23.999134063720817 0, 87.4610214233399 23.995758056640682 0, 87.46247100830072 23.987098693847656 0, 87.46063995361334 23.98369026184082 0, 87.4562606811524 23.98566246032709 0, 87.45164489746094 23.98656272888195 0, 87.44815063476574 23.98373794555664 0, 87.44178771972662 23.98040771484375 0, 87.43925476074219 23.981430053710994 0, 87.43667602539074 23.98396110534668 0, 87.4320068359375 23.984127044677734 0, 87.43029022216797 23.986242294311467 0, 87.43006134033203 23.990194320678825 0, 87.42906951904308 23.992580413818416 0, 87.42483520507824 23.99305343627924 0, 87.4212875366211 23.991611480712947 0, 87.41725158691418 23.99310111999506 0, 87.4030380249024 23.996170043945426 0, 87.39701080322277 23.998771667480526 0, 87.39661407470714 24.001476287841797 0, 87.39250183105469 24.004201889038086 0, 87.38510894775396 24.00494956970215 0, 87.37963867187511 24.00540733337408 0, 87.3767776489259 24.008815765380916 0, 87.36756896972662 24.009000778198242 0, 87.36316680908209 24.009569168090934 0, 87.35942840576183 24.011413574218864 0, 87.35762786865234 24.007827758789006 0, 87.3561401367188 24.004480361938477 0, 87.35375213623041 24.001440048217887 0, 87.3530044555664 23.99920845031744 0, 87.35089874267578 23.99802970886242 0, 87.34009552001959 23.99718856811529 0, 87.33067321777338 23.998226165771484 0, 87.32678222656256 23.99929237365717 0, 87.32270812988281 24.001405715942326 0, 87.32070922851574 24.003751754760856 0, 87.31822204589855 24.006639480590877 0, 87.31863403320324 24.009305953979435 0, 87.32112121582043 24.009090423583984 0, 87.32337188720714 24.01149177551281 0, 87.32506561279303 24.01536750793457 0, 87.32700347900402 24.019687652587947 0, 87.3302459716798 24.018827438354606 0, 87.33515167236334 24.019744873046932 0, 87.33600616455072 24.02446746826172 0, 87.33831787109375 24.02605628967285 0, 87.33518218994146 24.033205032348746 0, 87.32911682128918 24.032320022583008 0, 87.32281494140636 24.033626556396598 0, 87.31657409667969 24.034580230713004 0, 87.31163024902344 24.034133911132926 0, 87.30653381347662 24.031557083129883 0, 87.29942321777344 24.032344818115178 0, 87.29243469238287 24.03249549865717 0, 87.28908538818354 24.029365539550895 0, 87.28553771972662 24.029119491577262 0, 87.28202819824213 24.031536102295036 0, 87.27715301513678 24.034015655517692 0, 87.27208709716808 24.035186767578182 0, 87.26677703857416 24.03686904907238 0, 87.2607192993164 24.037649154663143 0, 87.25636291503912 24.039505004882756 0, 87.25193786621094 24.042289733886776 0, 87.24652099609386 24.04428291320812 0, 87.2409057617188 24.043376922607536 0, 87.23773193359386 24.03948593139654 0, 87.23640441894543 24.03486061096197 0, 87.23558807373053 24.026779174804688 0, 87.23559570312506 24.026746749877987 0, 87.22850799560553 24.02563858032238 0, 87.21967315673828 24.02559471130371 0, 87.21347045898443 24.02782249450678 0, 87.20550537109386 24.028936386108512 0, 87.19640350341797 24.027795791626033 0, 87.19018554687506 24.029050827026424 0, 87.18041229248047 24.030672073364315 0, 87.1748428344726 24.031757354736442 0, 87.16796112060558 24.032632827758903 0, 87.16293334960943 24.03502082824707 0, 87.16226959228516 24.035406112671012 0, 87.15185546875006 24.042695999145565 0, 87.14501953125006 24.04439926147461 0, 87.13914489746105 24.043474197387752 0, 87.13406372070312 24.045923233032283 0, 87.12770080566418 24.050643920898494 0, 87.12238311767572 24.05643463134777 0, 87.11763763427734 24.061254501342773 0, 87.11429595947271 24.06620407104498 0, 87.1118850708009 24.071571350097656 0, 87.11061096191406 24.077714920043945 0, 87.1065902709961 24.08306312561035 0, 87.10485076904297 24.088029861450195 0, 87.10379028320318 24.092412948608455 0, 87.10275268554688 24.09550285339367 0, 87.09892272949213 24.097063064575252 0, 87.09696197509777 24.09982872009283 0, 87.09884643554693 24.1030597686767 0, 87.09913635253906 24.10645866394043 0, 87.09658813476574 24.10758972167963 0, 87.09239959716808 24.106307983398438 0, 87.0897064208985 24.104866027832145 0, 87.08643341064459 24.10556983947754 0, 87.08316802978521 24.10645866394043 0, 87.08014678955084 24.106321334838924 0, 87.07191467285162 24.11135864257824 0, 87.07107543945307 24.11184120178217 0, 87.06623840332037 24.114616394043082 0, 87.06043243408203 24.118663787841854 0, 87.05831146240234 24.122079849243278 0, 87.05815887451172 24.122415542602596 0, 87.0562515258789 24.12669181823736 0, 87.05464172363293 24.12851715087902 0, 87.04980468750006 24.133810043335075 0, 87.04669189453125 24.1356258392334 0, 87.04396820068371 24.137212753295955 0, 87.04364013671875 24.137357711791992 0, 87.04244995117199 24.13788032531744 0, 87.03787994384777 24.139888763427848 0, 87.03341674804693 24.141567230224666 0, 87.02754211425793 24.14377593994152 0, 87.02645874023438 24.14430236816412 0, 87.0246200561524 24.145475387573356 0, 87.0212020874024 24.14913558959961 0, 87.01968383789068 24.148929595947266 0, 87.02161407470709 24.145614624023438 0, 87.02345275878906 24.142395019531307 0, 87.02433013916027 24.13820648193365 0, 87.0225677490235 24.13349342346197 0, 87.01921844482422 24.129220962524414 0, 86.99793243408209 24.127519607543945 0, 86.99497985839838 24.12682533264166 0, 86.99449920654303 24.127216339111385 0, 86.98812866210938 24.128335952758846 0, 86.98284149169928 24.129037857055664 0, 86.97966766357433 24.125955581664982 0, 86.97812652587896 24.11984825134283 0, 86.97874450683605 24.114564895629883 0, 86.97718811035168 24.109933853149357 0, 86.97710418701172 24.109899520874023 0, 86.97714233398443 24.1099529266358 0, 86.97162628173834 24.111902236938477 0, 86.96548461914068 24.114503860473576 0, 86.96166992187506 24.115871429443473 0, 86.96009063720703 24.12272453308111 0, 86.96001434326183 24.129404067993164 0, 86.95198059082037 24.132566452026367 0, 86.9420776367188 24.137678146362248 0, 86.93215179443365 24.139165878296012 0, 86.93177795410162 24.14430999755865 0, 86.93366241455084 24.151870727539062 0, 86.93549346923828 24.16045379638672 0, 86.93682861328125 24.164619445800724 0, 86.93920135498053 24.17112350463873 0, 86.94749450683594 24.169113159179744 0, 86.95066070556646 24.17001533508295 0, 86.95608520507812 24.178813934326286 0, 86.96132659912115 24.184347152710018 0, 86.97512817382824 24.186906814575252 0, 86.97417449951183 24.192880630493278 0, 86.97566986083996 24.202117919921932 0, 86.97241210937511 24.208507537841854 0, 86.97030639648443 24.213809967041072 0, 86.97205352783214 24.217702865600643 0, 86.97708129882812 24.220462799072266 0, 86.98591613769537 24.218986511230412 0, 86.99198913574219 24.218044281005916 0, 87.00064086914074 24.215036392211914 0, 87.01572418212902 24.20919799804699 0, 87.019271850586 24.209957122802734 0, 87.02314758300793 24.20630264282221 0, 87.02527618408214 24.203985214233455 0, 87.03124237060547 24.202527999877873 0, 87.035140991211 24.202667236328182 0, 87.0404891967774 24.199487686157283 0, 87.04420471191406 24.195837020874137 0, 87.048080444336 24.200160980224723 0, 87.05295562744135 24.204910278320312 0, 87.05038452148443 24.209619522094783 0, 87.05026245117199 24.2128963470459 0, 87.0504760742187 24.214941024780273 0, 87.04772186279303 24.220100402832145 0, 87.05113983154303 24.225543975830192 0, 87.05417633056646 24.228679656982422 0, 87.05563354492182 24.23392677307129 0, 87.05747222900396 24.23937606811529 0, 87.06135559082026 24.24294281005865 0, 87.06466674804693 24.24581909179699 0, 87.06764984130854 24.248327255249023 0, 87.06881713867188 24.253515243530273 0, 87.06307983398438 24.255704879760856 0, 87.0562515258789 24.25789833068859 0, 87.0489730834961 24.26012992858881 0, 87.04248809814453 24.262681961059684 0, 87.03807830810541 24.266614913940373 0, 87.03473663330084 24.272390365600586 0, 87.03202056884766 24.281433105468807 0, 87.03233337402355 24.29109001159668 0, 87.03210449218756 24.298290252685547 0, 87.03298950195312 24.304168701171932 0, 87.0337982177735 24.310768127441406 0, 87.03041076660168 24.317918777465877 0, 87.02305603027344 24.326404571533317 0, 86.99755859375006 24.312246322631836 0, 86.99616241455078 24.312732696533146 0, 86.99437713623058 24.312402725219783 0, 86.98562622070307 24.307003021240178 0, 86.97712707519537 24.31112098693859 0, 86.96602630615234 24.31230926513672 0, 86.96006011962902 24.317699432373047 0, 86.9598007202149 24.321935653686467 0, 86.95999145507818 24.32658195495611 0, 86.9603881835938 24.333616256713867 0, 86.9623794555664 24.342121124267578 0, 86.96216583251947 24.348936080932674 0, 86.96120452880871 24.355350494384822 0, 86.9509887695313 24.359245300293026 0, 86.93479156494146 24.35996055603033 0, 86.92755889892584 24.373737335205192 0, 86.92976379394531 24.37949562072754 0, 86.92322540283214 24.383703231811637 0, 86.9223022460937 24.388635635375977 0, 86.92280578613287 24.393722534179688 0, 86.92961883544922 24.396516799926815 0, 86.93411254882824 24.40184593200678 0, 86.93695068359386 24.40890502929699 0, 86.93939971923834 24.419963836669922 0, 86.93370819091808 24.42174148559576 0, 86.92998504638672 24.41784477233898 0, 86.92180633544928 24.41971778869629 0, 86.91854095458984 24.413511276245117 0, 86.91188812255865 24.40952301025385 0, 86.90752410888678 24.412719726562614 0, 86.901596069336 24.411767959594783 0, 86.89827728271479 24.414564132690487 0, 86.89531707763678 24.420389175415153 0, 86.8911590576173 24.424583435058537 0, 86.89553833007818 24.42641448974615 0, 86.89127349853516 24.432329177856445 0, 86.88307189941406 24.428533554077262 0, 86.88278198242199 24.433942794799805 0, 86.88337707519543 24.44053840637207 0, 86.88460540771484 24.44753837585455 0, 86.88744354248047 24.455093383789176 0, 86.89118957519543 24.4598770141601 0, 86.89701843261724 24.467531204223746 0, 86.90099334716797 24.475917816162166 0, 86.9043655395509 24.48273658752447 0, 86.90677642822271 24.48596763610834 0, 86.90937805175781 24.490030288696403 0, 86.9110488891601 24.495311737060547 0, 86.91141510009777 24.500534057617188 0, 86.91220092773432 24.506267547607536 0, 86.91149139404297 24.513032913208065 0, 86.90962219238287 24.522129058838004 0, 86.91077423095709 24.527204513549805 0, 86.91084289550793 24.533172607421875 0, 86.91474151611328 24.540142059326172 0))",both
JAMTARA,790207,403450,386757,439,"POLYGON Z ((86.57339477539074 24.140657424926758 0, 86.57444763183594 24.14280128479004 0, 86.57847595214844 24.142738342285156 0, 86.58187103271484 24.141723632812443 0, 86.58658599853527 24.14098358154297 0, 86.58989715576172 24.14392471313471 0, 86.59313201904297 24.144361495971623 0, 86.59746551513683 24.14380073547369 0, 86.60310363769537 24.14235877990717 0, 86.6075057983399 24.14254951477045 0, 86.6109237670899 24.143331527710018 0, 86.61648559570318 24.141368865966854 0, 86.62011718750006 24.139360427856445 0, 86.62320709228527 24.13822746276867 0, 86.63282012939453 24.137973785400504 0, 86.643539428711 24.136608123779354 0, 86.64978790283203 24.13492774963379 0, 86.65523529052746 24.13407135009777 0, 86.66244506835943 24.13429450988781 0, 86.66616821289062 24.134965896606445 0, 86.67188262939453 24.13503074645996 0, 86.67475891113281 24.13639831542963 0, 86.67790985107428 24.13950920104986 0, 86.68019104003912 24.143667221069393 0, 86.68265533447271 24.146945953369254 0, 86.68297576904297 24.152343750000057 0, 86.683822631836 24.15674018859869 0, 86.6866302490235 24.162403106689567 0, 86.6881713867188 24.166797637939567 0, 86.69255065917974 24.169471740722713 0, 86.69754791259771 24.16647338867199 0, 86.6998977661134 24.16477203369152 0, 86.70439910888678 24.162523269653434 0, 86.70649719238287 24.156129837036133 0, 86.70787811279308 24.14776802062994 0, 86.70219421386713 24.14497566223156 0, 86.69622039794928 24.144329071044922 0, 86.69310760498047 24.142913818359375 0, 86.69100189208984 24.1339950561524 0, 86.69030761718756 24.12257385253912 0, 86.69303894042963 24.117267608642578 0, 86.69843292236328 24.111766815185604 0, 86.70326232910162 24.110855102539062 0, 86.7102890014649 24.111265182495174 0, 86.71603393554693 24.108261108398494 0, 86.72798156738281 24.104503631591797 0, 86.74154663085938 24.100038528442383 0, 86.74974060058594 24.0989284515382 0, 86.75478363037121 24.098653793335018 0, 86.75961303710932 24.091878890991325 0, 86.75369262695307 24.086425781249943 0, 86.7568817138673 24.082862854003906 0, 86.7631225585938 24.078281402588004 0, 86.76565551757824 24.072002410888786 0, 86.77239227294916 24.07304763793951 0, 86.78040313720697 24.070476531982536 0, 86.7858505249024 24.07228660583496 0, 86.78579711914062 24.08330726623541 0, 86.79154205322271 24.084472656250114 0, 86.79563903808605 24.088895797729492 0, 86.80190277099621 24.084730148315487 0, 86.8060073852539 24.089622497558707 0, 86.80742645263683 24.088619232177678 0, 86.80815124511724 24.080783843994084 0, 86.81124877929699 24.07861328125 0, 86.82048034667969 24.078174591064453 0, 86.83094024658197 24.057006835937614 0, 86.84139251708996 24.056787490844783 0, 86.84458160400396 24.062500000000057 0, 86.85977935791016 24.066341400146484 0, 86.86531829833984 24.069057464599666 0, 86.8711395263673 24.067361831665153 0, 86.87548065185553 24.069564819335994 0, 86.87657928466797 24.073316574096737 0, 86.8796157836914 24.075357437133903 0, 86.88938140869146 24.07123184204113 0, 86.89934539794928 24.065265655517635 0, 86.91025543212902 24.067321777343864 0, 86.91560363769543 24.065170288085994 0, 86.91077423095709 24.06023979187006 0, 86.91609191894537 24.054372787475586 0, 86.9283294677735 24.04838752746582 0, 86.94114685058605 24.045110702514705 0, 86.94924926757812 24.04593658447277 0, 86.95704650878906 24.05053901672369 0, 86.95405578613287 24.05629539489746 0, 86.96144104003906 24.061943054199276 0, 86.97075653076166 24.06310462951666 0, 86.9706039428711 24.074583053588867 0, 86.97421264648438 24.080831527709904 0, 86.97335815429693 24.08920669555664 0, 86.97020721435547 24.100255966186637 0, 86.97710418701172 24.109899520874023 0, 86.97718811035168 24.109933853149357 0, 86.97874450683605 24.114564895629883 0, 86.97812652587896 24.11984825134283 0, 86.97966766357433 24.125955581664982 0, 86.98284149169928 24.129037857055664 0, 86.98812866210938 24.128335952758846 0, 86.99449920654303 24.127216339111385 0, 86.99497985839838 24.12682533264166 0, 86.99793243408209 24.127519607543945 0, 87.01921844482422 24.129220962524414 0, 87.0225677490235 24.13349342346197 0, 87.02433013916027 24.13820648193365 0, 87.02345275878906 24.142395019531307 0, 87.02161407470709 24.145614624023438 0, 87.01968383789068 24.148929595947266 0, 87.0212020874024 24.14913558959961 0, 87.0246200561524 24.145475387573356 0, 87.02645874023438 24.14430236816412 0, 87.02754211425793 24.14377593994152 0, 87.03341674804693 24.141567230224666 0, 87.03787994384777 24.139888763427848 0, 87.04244995117199 24.13788032531744 0, 87.04364013671875 24.137357711791992 0, 87.04396820068371 24.137212753295955 0, 87.04669189453125 24.1356258392334 0, 87.04980468750006 24.133810043335075 0, 87.05464172363293 24.12851715087902 0, 87.0562515258789 24.12669181823736 0, 87.05815887451172 24.122415542602596 0, 87.05831146240234 24.122079849243278 0, 87.06043243408203 24.118663787841854 0, 87.06623840332037 24.114616394043082 0, 87.07107543945307 24.11184120178217 0, 87.07191467285162 24.11135864257824 0, 87.08014678955084 24.106321334838924 0, 87.08316802978521 24.10645866394043 0, 87.08643341064459 24.10556983947754 0, 87.0897064208985 24.104866027832145 0, 87.09239959716808 24.106307983398438 0, 87.09658813476574 24.10758972167963 0, 87.09913635253906 24.10645866394043 0, 87.09884643554693 24.1030597686767 0, 87.09696197509777 24.09982872009283 0, 87.09892272949213 24.097063064575252 0, 87.10275268554688 24.09550285339367 0, 87.10379028320318 24.092412948608455 0, 87.10485076904297 24.088029861450195 0, 87.1065902709961 24.08306312561035 0, 87.11061096191406 24.077714920043945 0, 87.1118850708009 24.071571350097656 0, 87.11429595947271 24.06620407104498 0, 87.11763763427734 24.061254501342773 0, 87.12238311767572 24.05643463134777 0, 87.12770080566418 24.050643920898494 0, 87.13406372070312 24.045923233032283 0, 87.13914489746105 24.043474197387752 0, 87.14501953125006 24.04439926147461 0, 87.15185546875006 24.042695999145565 0, 87.16226959228516 24.035406112671012 0, 87.16293334960943 24.03502082824707 0, 87.16796112060558 24.032632827758903 0, 87.1748428344726 24.031757354736442 0, 87.18041229248047 24.030672073364315 0, 87.19018554687506 24.029050827026424 0, 87.19640350341797 24.027795791626033 0, 87.20550537109386 24.028936386108512 0, 87.21347045898443 24.02782249450678 0, 87.21967315673828 24.02559471130371 0, 87.22850799560553 24.02563858032238 0, 87.23559570312506 24.026746749877987 0, 87.23829650878918 24.019739151000977 0, 87.24214172363293 24.016971588134822 0, 87.24326324462902 24.012863159179688 0, 87.24348449707043 24.007923126220646 0, 87.24645996093756 24.003223419189453 0, 87.24829864501953 24.000764846801815 0, 87.24868774414062 24.00023651123047 0, 87.2490463256836 23.999864578247013 0, 87.24977111816418 23.999250411987305 0, 87.2501831054687 23.99898910522461 0, 87.25060272216797 23.998743057250977 0, 87.2510604858399 23.998533248901424 0, 87.25151824951166 23.998350143432674 0, 87.25199127197271 23.998207092285213 0, 87.25249481201172 23.99808883666998 0, 87.25299072265636 23.99799728393566 0, 87.25348663330078 23.997943878173885 0, 87.25399017333979 23.997924804687443 0, 87.25448608398443 23.997945785522518 0, 87.25497436523438 23.997993469238338 0, 87.25550079345714 23.998086929321346 0, 87.25600433349615 23.998207092285213 0, 87.25650024414062 23.9983749389649 0, 87.25697326660162 23.99857902526867 0, 87.25740814208996 23.998823165893498 0, 87.25782012939453 23.999094009399528 0, 87.2581939697265 23.99939537048334 0, 87.25853729248058 23.999732971191463 0, 87.25883483886724 24.000099182128963 0, 87.25910949707043 24.000488281250057 0, 87.25929260253918 24.001310348510685 0, 87.26007080078136 24.00199317932129 0, 87.26369476318371 24.00511169433605 0, 87.26557922363293 24.001333236694336 0, 87.26493835449224 23.997310638427734 0, 87.26979064941418 23.990011215210075 0, 87.27088928222662 23.986867904663086 0, 87.26889038085938 23.984071731567383 0, 87.26360321044928 23.980339050293082 0, 87.26239776611328 23.972167968749943 0, 87.26440429687506 23.96841239929205 0, 87.26738739013672 23.965740203857536 0, 87.2721099853515 23.967576980590877 0, 87.28089141845697 23.959829330444393 0, 87.28951263427734 23.95976257324213 0, 87.2946548461914 23.95797348022461 0, 87.2933120727539 23.94973564147955 0, 87.2947387695313 23.941043853759766 0, 87.28793334960949 23.936191558838004 0, 87.29064178466797 23.928264617919922 0, 87.29049682617193 23.92254829406744 0, 87.29732513427734 23.900924682617244 0, 87.293472290039 23.90105056762701 0, 87.29538726806635 23.892505645752067 0, 87.28829956054699 23.88596725463873 0, 87.28408050537121 23.8865642547608 0, 87.2811279296875 23.88431739807129 0, 87.27322387695324 23.875320434570312 0, 87.26771545410168 23.87720489501953 0, 87.26456451416021 23.880538940429744 0, 87.26694488525402 23.882335662841854 0, 87.26371002197277 23.894529342651367 0, 87.25914001464838 23.900489807128906 0, 87.26269531250006 23.904449462890568 0, 87.26202392578125 23.906538009643555 0, 87.25949096679699 23.909923553466797 0, 87.25527954101574 23.912425994873047 0, 87.25106811523443 23.90933609008789 0, 87.2471694946289 23.902725219726676 0, 87.24891662597662 23.897283554077205 0, 87.24594116210949 23.887212753296012 0, 87.24813079833984 23.88297462463379 0, 87.2472610473634 23.88044929504406 0, 87.2476959228515 23.870779037475643 0, 87.2518768310548 23.86823081970215 0, 87.24891662597662 23.8589706420899 0, 87.25025177001959 23.85370826721197 0, 87.2543411254884 23.85006713867199 0, 87.25550079345714 23.845272064208984 0, 87.25801086425781 23.841720581054688 0, 87.24852752685547 23.830499649047795 0, 87.24554443359386 23.82859611511236 0, 87.24160766601562 23.82728195190441 0, 87.23657989501964 23.82777595520031 0, 87.23194885253912 23.825439453125114 0, 87.22257995605469 23.829629898071346 0, 87.22138214111322 23.833217620849553 0, 87.22517395019543 23.83723449707037 0, 87.2269515991211 23.845088958740234 0, 87.2307968139649 23.845308303833065 0, 87.23455047607422 23.84696769714367 0, 87.2379608154298 23.850646972656364 0, 87.23906707763683 23.85546493530279 0, 87.23065948486334 23.857688903808707 0, 87.22532653808605 23.860025405883903 0, 87.21960449218761 23.853336334228572 0, 87.2156753540039 23.852659225463924 0, 87.2101821899414 23.855400085449332 0, 87.20589447021496 23.848571777343693 0, 87.20231628417969 23.84989929199213 0, 87.19718933105469 23.844518661498967 0, 87.19451141357422 23.842838287353572 0, 87.19143676757807 23.843236923217773 0, 87.19158172607433 23.848707199096623 0, 87.19828033447277 23.85325050354004 0, 87.19852447509766 23.856643676757812 0, 87.1902313232423 23.859560012817383 0, 87.18714904785162 23.85529708862316 0, 87.18346405029297 23.8539199829101 0, 87.1795043945313 23.85484695434576 0, 87.17584228515625 23.858602523803825 0, 87.17200469970703 23.860168457031364 0, 87.16959381103521 23.862865447998104 0, 87.15959930419922 23.86725044250494 0, 87.15582275390625 23.86794662475586 0, 87.1504287719726 23.865041732788143 0, 87.14369964599621 23.867460250854492 0, 87.14151763916016 23.869754791259822 0, 87.13875579833996 23.870494842529354 0, 87.13387298583984 23.869310379028377 0, 87.13079833984375 23.864797592163086 0, 87.13258361816412 23.860498428344727 0, 87.13236236572266 23.85727310180664 0, 87.13326263427729 23.85328102111822 0, 87.14064025878918 23.848196029663086 0, 87.14871978759766 23.83900260925293 0, 87.15689086914074 23.828151702880916 0, 87.16202545166027 23.830715179443473 0, 87.16510009765636 23.830032348632926 0, 87.16932678222656 23.822010040283203 0, 87.15879821777355 23.806156158447266 0, 87.15651702880871 23.80089950561529 0, 87.1516342163086 23.79682350158697 0, 87.14644622802734 23.798803329467773 0, 87.14209747314453 23.802499771118164 0, 87.13652038574219 23.79878807067871 0, 87.12707519531256 23.797483444213924 0, 87.11592102050781 23.799257278442383 0, 87.11318206787121 23.80149459838873 0, 87.11759185791027 23.802518844604606 0, 87.1192474365235 23.804399490356445 0, 87.11902618408209 23.80722618103033 0, 87.11550903320324 23.807970046997184 0, 87.11064147949224 23.80429840087902 0, 87.10885620117188 23.801952362060547 0, 87.09865570068365 23.811912536621207 0, 87.09425354003912 23.812032699585018 0, 87.09135437011719 23.81023025512701 0, 87.0874710083009 23.807678222656307 0, 87.08422088623058 23.8129043579101 0, 87.08163452148438 23.814554214477596 0, 87.07267761230474 23.818323135375977 0, 87.06254577636719 23.823507308960075 0, 87.03742980957037 23.839197158813533 0, 87.02547454833996 23.84287834167486 0, 87.01650238037121 23.849292755126953 0, 87.00513458251953 23.85482406616211 0, 86.99761199951183 23.855861663818473 0, 86.98320770263672 23.858707427978572 0, 86.97496795654297 23.865148544311523 0, 86.97002410888672 23.867612838745117 0, 86.96615600585949 23.867084503173885 0, 86.96266937255865 23.864618301391715 0, 86.9608306884765 23.861461639404297 0, 86.95886993408214 23.851932525634766 0, 86.95433807373058 23.84820175170904 0, 86.94631958007824 23.84519004821783 0, 86.93950653076172 23.847196578979435 0, 86.93126678466791 23.852291107177678 0, 86.92855072021496 23.856155395507926 0, 86.92731475830078 23.86817359924322 0, 86.91005706787121 23.881784439087028 0, 86.90685272216791 23.881240844726562 0, 86.89820098876959 23.882219314575195 0, 86.89456176757818 23.87866783142084 0, 86.88780975341797 23.87562370300293 0, 86.88327026367188 23.868783950805778 0, 86.87846374511719 23.86466789245611 0, 86.87857055664074 23.859745025634766 0, 86.8854446411134 23.858909606933594 0, 86.88336181640636 23.844518661498967 0, 86.88796997070307 23.83669662475586 0, 86.8879013061524 23.832820892334098 0, 86.8900756835937 23.82966423034668 0, 86.89085388183594 23.8245086669923 0, 86.88754272460949 23.821546554565487 0, 86.88542938232428 23.81683158874523 0, 86.88011932373058 23.815801620483455 0, 86.88011932373058 23.823671340942383 0, 86.87648010253918 23.82956504821783 0, 86.87628173828136 23.83680343627941 0, 86.87442016601574 23.846490859985465 0, 86.86405181884771 23.84448051452648 0, 86.86025238037115 23.841817855835075 0, 86.85767364501953 23.834796905517578 0, 86.847640991211 23.82417869567871 0, 86.83824157714844 23.821590423583928 0, 86.82913970947271 23.815538406372127 0, 86.82398986816412 23.81364822387701 0, 86.8170394897461 23.81449317932129 0, 86.81253051757818 23.816459655761776 0, 86.8102645874024 23.820474624633846 0, 86.81111145019526 23.82686805725092 0, 86.80970001220709 23.83041381835949 0, 86.80692291259766 23.832988739013786 0, 86.80344390869152 23.834941864013615 0, 86.80065155029297 23.83417129516596 0, 86.79611206054693 23.833679199218864 0, 86.78435516357433 23.858499526977653 0, 86.78034973144543 23.863296508789062 0, 86.77515411376959 23.86695861816412 0, 86.77098846435553 23.87303924560547 0, 86.76727294921875 23.87661933898937 0, 86.76342773437494 23.878997802734432 0, 86.74649047851562 23.884315490722713 0, 86.74101257324224 23.88175582885748 0, 86.73166656494146 23.87499809265148 0, 86.72879028320318 23.876956939697266 0, 86.72242736816406 23.88462448120123 0, 86.71971130371105 23.892585754394645 0, 86.71718597412115 23.907581329345817 0, 86.71041107177734 23.91750907897955 0, 86.70443725585949 23.9235076904298 0, 86.68769836425776 23.926017761230412 0, 86.67008209228521 23.937160491943303 0, 86.65582275390636 23.940561294555607 0, 86.64511871337902 23.946441650390625 0, 86.64000701904308 23.952318191528377 0, 86.59790802001953 23.975257873535156 0, 86.59447479248047 23.981025695800838 0, 86.58460998535162 23.990736007690487 0, 86.57744598388683 23.999656677246094 0, 86.57159423828125 24.002079010009766 0, 86.53984832763683 24.006134033203125 0, 86.52216339111328 23.999565124511776 0, 86.51512145996094 24.00098991394043 0, 86.50222778320318 24.007659912109375 0, 86.49972534179693 24.01033973693859 0, 86.49813079833984 24.012027740478572 0, 86.49609375000006 24.01345062255865 0, 86.49447631835949 24.014373779296875 0, 86.49270629882818 24.01469421386713 0, 86.49060058593756 24.014163970947322 0, 86.4889526367187 24.013422012329045 0, 86.48595428466797 24.011922836303768 0, 86.4837036132813 24.01110458374029 0, 86.48062133789062 24.010808944702262 0, 86.47814178466797 24.01170158386236 0, 86.47521209716808 24.013740539550724 0, 86.47164154052734 24.015832901001033 0, 86.46858215332031 24.018484115600586 0, 86.47239685058594 24.020721435546932 0, 86.47930145263678 24.022640228271484 0, 86.48444366455078 24.023983001708984 0, 86.48450469970709 24.02995681762701 0, 86.47859954833996 24.026556015014705 0, 86.47799682617193 24.034938812255916 0, 86.48149871826183 24.044639587402287 0, 86.48696899414068 24.044664382934684 0, 86.49098968505865 24.045963287353572 0, 86.49686431884771 24.045038223266715 0, 86.5047225952149 24.0502872467041 0, 86.51353454589855 24.052173614501896 0, 86.51893615722656 24.05380439758312 0, 86.53060913085943 24.05710792541504 0, 86.53307342529297 24.063491821289176 0, 86.53626251220697 24.069276809692496 0, 86.54155731201183 24.072961807250977 0, 86.54502868652338 24.0774822235108 0, 86.54568481445318 24.085763931274414 0, 86.54946899414062 24.0969562530517 0, 86.5533294677735 24.09978103637701 0, 86.55583190917974 24.102790832519645 0, 86.55872344970714 24.112148284912166 0, 86.56183624267578 24.1240234375 0, 86.5651473999024 24.127500534057674 0, 86.56560516357433 24.135595321655273 0, 86.56813049316406 24.140005111694336 0, 86.57339477539074 24.140657424926758 0))",both
RANCHI,2912022,1493376,1418646,557,"POLYGON Z ((84.98744201660168 23.700496673583984 0, 84.99014282226574 23.689888000488224 0, 84.99539947509771 23.681772232055664 0, 85.00000000000006 23.680368423462028 0, 85.00503540039057 23.678831100463867 0, 85.00930786132818 23.687273025512695 0, 85.00962066650385 23.693374633789062 0, 85.01332855224615 23.691856384277344 0, 85.01560211181646 23.687500000000057 0, 85.03399658203136 23.690149307250977 0, 85.03636169433594 23.693536758422965 0, 85.03907775878912 23.699995040893555 0, 85.03926086425787 23.703815460205135 0, 85.04445648193365 23.706317901611385 0, 85.0464248657226 23.708312988281307 0, 85.04761505126953 23.711790084838867 0, 85.05162048339844 23.714031219482422 0, 85.05335998535156 23.710706710815487 0, 85.05563354492188 23.70969390869152 0, 85.05610656738293 23.709798812866268 0, 85.06629943847656 23.712034225463924 0, 85.06835937499994 23.708326339721623 0, 85.06798553466791 23.704410552978572 0, 85.06932067871088 23.69972229003912 0, 85.06504058837896 23.69757080078125 0, 85.05934143066418 23.69805335998541 0, 85.05615997314447 23.69304084777832 0, 85.05722808837896 23.689252853393498 0, 85.0629501342774 23.68379783630371 0, 85.07015991210943 23.679313659668026 0, 85.07719421386719 23.673433303833065 0, 85.07564544677734 23.669393539428825 0, 85.08276367187506 23.67015266418457 0, 85.09767913818371 23.668149948120117 0, 85.10536956787104 23.66451072692871 0, 85.11859130859375 23.66695785522461 0, 85.12265777587896 23.666601181030273 0, 85.12702178955084 23.66837120056158 0, 85.15209960937494 23.67251777648937 0, 85.15586853027355 23.6749725341798 0, 85.16350555419933 23.66696548461914 0, 85.17100524902344 23.679191589355412 0, 85.17235565185547 23.685314178466854 0, 85.17887115478521 23.69251060485834 0, 85.18665313720703 23.71031951904297 0, 85.19682312011724 23.708448410034237 0, 85.2162704467774 23.701244354248047 0, 85.22309112548828 23.700832366943473 0, 85.22436523437511 23.699405670166072 0, 85.22118377685547 23.690448760986385 0, 85.2238159179687 23.68620872497553 0, 85.22796630859386 23.68498039245611 0, 85.2340545654298 23.687273025512695 0, 85.23583221435541 23.68625068664562 0, 85.23543548583996 23.683313369750977 0, 85.2260360717774 23.67637252807623 0, 85.22285461425776 23.675601959228572 0, 85.21942901611322 23.666517257690543 0, 85.22095489501947 23.660886764526367 0, 85.21885681152338 23.659023284912223 0, 85.21990203857428 23.65551948547369 0, 85.21177673339855 23.655847549438477 0, 85.20953369140625 23.651281356811637 0, 85.20339202880871 23.64395713806158 0, 85.20201873779308 23.639619827270508 0, 85.20217895507818 23.633859634399357 0, 85.20690917968756 23.622541427612305 0, 85.21213531494152 23.619935989379826 0, 85.23033905029297 23.619461059570426 0, 85.23419952392584 23.620132446289062 0, 85.23437500000006 23.61678695678711 0, 85.23839569091803 23.611581802368164 0, 85.24272155761719 23.603319168090934 0, 85.2421264648437 23.596736907958984 0, 85.26182556152344 23.58763122558605 0, 85.26393127441406 23.584712982177734 0, 85.2646713256836 23.581777572631893 0, 85.26618194580078 23.58075904846197 0, 85.27098846435547 23.580915451049748 0, 85.27913665771484 23.579431533813533 0, 85.29565429687506 23.574277877807617 0, 85.30867767333996 23.573011398315487 0, 85.31876373291027 23.570333480835018 0, 85.32386779785162 23.56836128234869 0, 85.33398437500006 23.560091018676758 0, 85.33780670166021 23.559150695800838 0, 85.34777069091808 23.56199836730957 0, 85.36369323730474 23.56243324279791 0, 85.36761474609386 23.559410095214787 0, 85.3836669921875 23.550672531127987 0, 85.38587188720709 23.558702468872013 0, 85.38925933837896 23.562246322631836 0, 85.3924331665039 23.55812263488764 0, 85.39752197265636 23.556379318237305 0, 85.4027252197265 23.555793762206974 0, 85.40827178955078 23.55687522888195 0, 85.4119491577149 23.561574935913143 0, 85.4178466796875 23.56007003784191 0, 85.42617034912121 23.554725646972713 0, 85.44398498535156 23.549858093261832 0, 85.45042419433594 23.54991531372076 0, 85.46140289306646 23.555183410644645 0, 85.46936798095709 23.558015823364315 0, 85.47007751464844 23.565462112426815 0, 85.46834564208984 23.56872367858881 0, 85.47050476074224 23.57191848754877 0, 85.48623657226574 23.563398361206055 0, 85.48596954345709 23.56028175354004 0, 85.48148345947277 23.554546356201115 0, 85.48586273193371 23.549167633056754 0, 85.49198913574213 23.54402351379389 0, 85.50009918212896 23.544841766357422 0, 85.50862884521484 23.541801452636776 0, 85.5137176513673 23.54512214660656 0, 85.5129013061524 23.554792404174748 0, 85.50936889648438 23.562721252441406 0, 85.50423431396484 23.56774711608898 0, 85.50345611572266 23.570676803588867 0, 85.51136016845709 23.572761535644474 0, 85.51518249511724 23.576820373535156 0, 85.52029418945318 23.577493667602596 0, 85.52258300781256 23.575672149658317 0, 85.52307891845697 23.57025337219244 0, 85.52557373046875 23.565729141235465 0, 85.52657318115234 23.561523437499943 0, 85.51823425292974 23.54337692260748 0, 85.5224990844726 23.537179946899414 0, 85.52817535400402 23.53318977355957 0, 85.5306243896485 23.532754898071232 0, 85.5334243774414 23.538135528564567 0, 85.53809356689464 23.539840698242188 0, 85.54439544677746 23.540229797363338 0, 85.54911041259771 23.538545608520508 0, 85.5687026977539 23.515300750732422 0, 85.57621002197271 23.509773254394645 0, 85.58683776855469 23.503683090209904 0, 85.59098815917969 23.495647430419922 0, 85.59590148925793 23.49251747131342 0, 85.6044311523438 23.48975563049322 0, 85.60527801513666 23.482383728027344 0, 85.61136627197277 23.478981018066406 0, 85.62561798095709 23.472803115844783 0, 85.63027954101562 23.469264984130973 0, 85.63643646240234 23.466825485229606 0, 85.64237976074224 23.465551376342773 0, 85.65724945068365 23.465129852294922 0, 85.66072082519537 23.461814880371094 0, 85.6710662841798 23.457395553588867 0, 85.67294311523449 23.451471328735465 0, 85.68303680419928 23.448778152465877 0, 85.7049179077149 23.445529937744197 0, 85.70899200439464 23.44434547424322 0, 85.71250915527344 23.442296981811523 0, 85.71682739257824 23.441631317138615 0, 85.72006225585949 23.442399978637695 0, 85.72293853759777 23.447662353515625 0, 85.72917938232428 23.45352554321289 0, 85.73146820068365 23.45002365112299 0, 85.73459625244135 23.44872474670416 0, 85.73939514160156 23.450307846069336 0, 85.74484252929699 23.45362091064453 0, 85.74748229980474 23.458364486694393 0, 85.75650787353527 23.460557937622127 0, 85.76914978027344 23.458559036254826 0, 85.77156829833996 23.459384918212834 0, 85.77676391601562 23.458950042724723 0, 85.78016662597668 23.455347061157227 0, 85.78916931152344 23.45448112487793 0, 85.79290771484386 23.455133438110295 0, 85.79639434814447 23.449916839599666 0, 85.80051422119146 23.449876785278377 0, 85.80322265625011 23.45427894592291 0, 85.81445312500006 23.45433807373047 0, 85.82071685791021 23.452938079833984 0, 85.82492828369146 23.450778961181754 0, 85.8283309936524 23.44670486450201 0, 85.82766723632824 23.43880844116211 0, 85.8373489379884 23.432531356811467 0, 85.84069061279297 23.428514480590877 0, 85.84389495849604 23.421276092529297 0, 85.84811401367188 23.422910690307674 0, 85.84725952148443 23.427345275878963 0, 85.8495559692384 23.42851066589367 0, 85.85433959960949 23.424907684326172 0, 85.8575897216798 23.42423820495611 0, 85.86483001708996 23.43064117431652 0, 85.8668212890625 23.41246223449707 0, 85.87614440917969 23.41102790832531 0, 85.87812042236334 23.41300392150879 0, 85.88237762451183 23.410528182983455 0, 85.88564300537121 23.406225204467773 0, 85.88223266601557 23.404663085937557 0, 85.88124084472668 23.40294837951666 0, 85.88870239257824 23.389879226684684 0, 85.8860473632812 23.386245727539062 0, 85.88638305664074 23.383647918701115 0, 85.89448547363281 23.383571624755916 0, 85.8982391357423 23.382230758666992 0, 85.89975738525402 23.37953758239746 0, 85.89956665039074 23.37315177917486 0, 85.89727020263683 23.372104644775447 0, 85.88918304443365 23.376308441162166 0, 85.87894439697277 23.370840072631893 0, 85.87017822265636 23.36740684509283 0, 85.87057495117199 23.364042282104606 0, 85.87692260742188 23.359468460083065 0, 85.87668609619152 23.35785293579113 0, 85.87477874755871 23.355102539062614 0, 85.87550354003918 23.332771301269645 0, 85.87924957275396 23.33135986328125 0, 85.88140106201178 23.328882217407227 0, 85.88186645507812 23.326337814331055 0, 85.87913513183605 23.32331085205078 0, 85.87221527099615 23.318504333496207 0, 85.86467742919916 23.317607879638786 0, 85.86540985107433 23.305974960327205 0, 85.8617553710938 23.30372619628912 0, 85.85633087158203 23.29712104797369 0, 85.84839630126959 23.29222869873047 0, 85.84564971923828 23.28698158264166 0, 85.84304809570318 23.284744262695426 0, 85.83758544921886 23.283342361450195 0, 85.83027648925787 23.265813827514762 0, 85.83457946777344 23.245946884155387 0, 85.83573913574219 23.22058486938471 0, 85.83457946777344 23.21673583984375 0, 85.83461761474615 23.213411331176815 0, 85.83671569824224 23.20891761779785 0, 85.8376235961914 23.204685211181697 0, 85.83544158935558 23.197914123535213 0, 85.83628845214844 23.195442199707145 0, 85.83890533447277 23.194896697998047 0, 85.84779357910162 23.196931838989258 0, 85.85578918457037 23.1953449249267 0, 85.86138153076183 23.197166442871207 0, 85.86370849609386 23.19520187377924 0, 85.88105773925793 23.175813674926815 0, 85.8816528320312 23.173860549926758 0, 85.88042449951178 23.1641464233399 0, 85.88114929199219 23.161531448364315 0, 85.89022827148449 23.15623283386236 0, 85.89299774169928 23.154642105102596 0, 85.88620758056652 23.15536880493164 0, 85.88529968261719 23.152685165405387 0, 85.8819198608399 23.150264739990234 0, 85.8785858154298 23.150598526000977 0, 85.87393951416021 23.148395538330135 0, 85.87061309814453 23.145725250244197 0, 85.86906433105463 23.14191436767578 0, 85.87029266357428 23.134717941284237 0, 85.87025451660156 23.129135131835938 0, 85.86818695068365 23.126462936401367 0, 85.86447143554699 23.12693214416504 0, 85.85765838623047 23.13035011291504 0, 85.85056304931635 23.120056152343807 0, 85.84574127197277 23.118932723999137 0, 85.84181213378906 23.1156330108642 0, 85.83977508544928 23.11070060729986 0, 85.83967590332043 23.106954574584904 0, 85.83769226074224 23.10462951660162 0, 85.83427429199224 23.102724075317383 0, 85.83336639404308 23.09888839721674 0, 85.82811737060547 23.092435836792106 0, 85.82394409179693 23.091663360595703 0, 85.8203811645509 23.08633804321289 0, 85.81234741210943 23.06860542297369 0, 85.8075561523438 23.06818771362299 0, 85.80265045166027 23.066793441772518 0, 85.79920959472668 23.06394004821783 0, 85.79690551757818 23.059703826904354 0, 85.79813385009766 23.056045532226676 0, 85.80558013916016 23.053628921508732 0, 85.8095169067384 23.043676376342773 0, 85.81198120117199 23.034357070922965 0, 85.81652832031256 23.02619171142578 0, 85.81871795654291 23.01219177246088 0, 85.8215713500976 23.006462097168082 0, 85.82210540771496 23.00329971313488 0, 85.82153320312511 23.0025310516358 0, 85.82474517822271 22.99691390991211 0, 85.83129119873058 22.99154663085949 0, 85.8403930664063 22.988037109375 0, 85.84603118896484 22.987304687500057 0, 85.84619140625 22.97990226745617 0, 85.84939575195324 22.962265014648438 0, 85.84947967529297 22.948669433593864 0, 85.85137176513672 22.945110321045036 0, 85.86182403564447 22.946716308593807 0, 85.86267089843756 22.943166732788086 0, 85.86671447753912 22.93961906433117 0, 85.86769104003918 22.935266494751033 0, 85.87260437011724 22.933002471923828 0, 85.87364959716791 22.930454254150504 0, 85.87067413330084 22.927377700805607 0, 85.86727905273443 22.918346405029354 0, 85.86843109130865 22.916086196899528 0, 85.86769104003918 22.91277885437006 0, 85.8579559326173 22.905132293701172 0, 85.85523986816412 22.901031494140625 0, 85.85792541503912 22.89697456359869 0, 85.86116027832037 22.887762069702262 0, 85.85678100585943 22.884641647338924 0, 85.84910583496094 22.885103225708065 0, 85.83738708496105 22.89030838012701 0, 85.83469390869152 22.89297485351574 0, 85.83280181884777 22.89726066589361 0, 85.83470916748058 22.902700424194336 0, 85.83460235595703 22.905429840088004 0, 85.82655334472656 22.904554367065543 0, 85.82108306884771 22.905540466308707 0, 85.81617736816418 22.907625198364315 0, 85.8092269897461 22.907745361328125 0, 85.79957580566412 22.910804748535213 0, 85.78706359863281 22.920070648193416 0, 85.78005981445312 22.922676086425838 0, 85.77262878417974 22.922382354736385 0, 85.76704406738281 22.926490783691463 0, 85.76477813720703 22.93066215515148 0, 85.76079559326172 22.93390274047846 0, 85.74983978271496 22.933132171630803 0, 85.74530029296875 22.93666267395031 0, 85.73915863037121 22.94001770019537 0, 85.72895812988287 22.942617416381893 0, 85.71851348876959 22.94278144836437 0, 85.7023391723634 22.944456100463867 0, 85.69509124755871 22.941326141357536 0, 85.69052886962902 22.93726348876953 0, 85.68063354492188 22.93529319763178 0, 85.67178344726568 22.9355792999267 0, 85.65568542480469 22.93834495544428 0, 85.65100860595714 22.93759155273449 0, 85.65327453613287 22.92774581909191 0, 85.6497039794923 22.921955108642578 0, 85.64459228515625 22.92021751403803 0, 85.6317596435548 22.91956710815441 0, 85.61983489990234 22.916894912719727 0, 85.61688232421886 22.91827201843273 0, 85.613021850586 22.92359542846674 0, 85.61473846435553 22.929506301879883 0, 85.61406707763672 22.933094024658317 0, 85.60490417480463 22.93626785278326 0, 85.59107208251959 22.922466278076115 0, 85.58123779296886 22.910467147827262 0, 85.5787734985351 22.906242370605526 0, 85.58000183105474 22.900335311889762 0, 85.58129119873047 22.898777008056754 0, 85.58891296386719 22.899198532104606 0, 85.6013793945313 22.89602661132824 0, 85.5981903076173 22.892198562622127 0, 85.58927154541016 22.885988235473576 0, 85.5858993530274 22.881418228149414 0, 85.57820892333984 22.866586685180664 0, 85.55978393554693 22.861925125122184 0, 85.55842590332031 22.86632156372076 0, 85.5586776733399 22.874773025512695 0, 85.55782318115234 22.881202697753906 0, 85.5466995239259 22.87509727478033 0, 85.54165649414068 22.870342254638786 0, 85.53919982910162 22.866577148437557 0, 85.53189086914062 22.869050979614258 0, 85.5320816040039 22.866275787353572 0, 85.5284423828125 22.864303588867244 0, 85.53035736083984 22.853879928588867 0, 85.52624511718756 22.84530830383312 0, 85.52108764648443 22.843852996826286 0, 85.51924133300793 22.836959838867188 0, 85.51875305175781 22.830993652343693 0, 85.51272583007824 22.829475402831974 0, 85.51476287841803 22.820854187011832 0, 85.5146865844726 22.809156417846793 0, 85.51464843750011 22.809144973754883 0, 85.51041412353521 22.807949066162166 0, 85.50248718261719 22.80109405517578 0, 85.49818420410162 22.800687789916992 0, 85.48959350585943 22.803785324096737 0, 85.48038482666016 22.80515861511242 0, 85.46902465820318 22.800434112548828 0, 85.46195983886724 22.8008270263673 0, 85.45581817626959 22.802255630493107 0, 85.45189666748058 22.80606651306158 0, 85.45084381103516 22.81040954589838 0, 85.44703674316406 22.818794250488224 0, 85.44555664062506 22.819831848144588 0, 85.44156646728521 22.82017326354986 0, 85.43843078613281 22.822240829467773 0, 85.4360961914062 22.829708099365348 0, 85.4334487915039 22.8333415985108 0, 85.4302597045899 22.835882186889762 0, 85.41840362548828 22.832199096679688 0, 85.41588592529291 22.836362838745117 0, 85.4121322631836 22.83727455139166 0, 85.4059829711914 22.844442367553825 0, 85.39873504638672 22.844823837280387 0, 85.38811492919928 22.84194755554205 0, 85.38614654541016 22.846809387207145 0, 85.3896942138673 22.855276107788143 0, 85.38735198974615 22.863773345947266 0, 85.38359832763683 22.865673065185547 0, 85.3720474243164 22.8623371124267 0, 85.37094116210943 22.86268424987793 0, 85.35588073730474 22.871952056884766 0, 85.3545150756836 22.87907409667963 0, 85.35039520263678 22.880674362182674 0, 85.34167480468761 22.880128860473633 0, 85.34038543701172 22.88556480407715 0, 85.33159637451172 22.88281059265148 0, 85.31925201416021 22.88132095336914 0, 85.31611633300793 22.883049011230582 0, 85.31278991699224 22.882972717285213 0, 85.31063842773438 22.884880065918026 0, 85.30780792236334 22.88335609436035 0, 85.30647277832037 22.877685546875114 0, 85.3035888671875 22.874893188476562 0, 85.29682922363293 22.87567520141613 0, 85.28896331787115 22.87356376647955 0, 85.2874374389649 22.870885848999023 0, 85.28565216064453 22.872730255126953 0, 85.28418731689459 22.86960411071783 0, 85.280746459961 22.870864868164006 0, 85.27957153320312 22.8699893951416 0, 85.27565765380871 22.864704132080078 0, 85.27400207519531 22.8610458374024 0, 85.27160644531256 22.862598419189453 0, 85.26663208007818 22.860319137573185 0, 85.26670074462902 22.856792449951286 0, 85.2647323608399 22.85504722595215 0, 85.26554107666027 22.850296020507812 0, 85.26395416259771 22.846351623535213 0, 85.25990295410156 22.84529685974121 0, 85.25682830810547 22.8471298217774 0, 85.25389099121105 22.844459533691463 0, 85.24745941162104 22.835220336914062 0, 85.24211883544916 22.835020065307617 0, 85.2326431274414 22.837646484375114 0, 85.22644042968761 22.83831024169922 0, 85.22084808349615 22.83451652526861 0, 85.21388244628918 22.824697494506836 0, 85.20418548583984 22.819145202636832 0, 85.19842529296886 22.8149471282959 0, 85.19577789306635 22.81829071044922 0, 85.19388580322266 22.812953948974723 0, 85.18904113769543 22.812585830688477 0, 85.18786621093756 22.814893722534293 0, 85.19208526611334 22.82099533081049 0, 85.19226074218756 22.82441711425787 0, 85.18968200683594 22.825906753539982 0, 85.18088531494152 22.825456619262752 0, 85.17645263671886 22.83011817932129 0, 85.17153167724621 22.833683013916072 0, 85.1665496826173 22.83522224426281 0, 85.16010284423822 22.832925796508903 0, 85.156494140625 22.82972335815441 0, 85.15435028076183 22.824380874633732 0, 85.15805053710938 22.82225799560547 0, 85.1466064453125 22.806793212890625 0, 85.13871002197277 22.778434753418026 0, 85.1386337280274 22.765523910522404 0, 85.13736724853527 22.75943374633789 0, 85.13831329345714 22.752212524414176 0, 85.14501953125011 22.74548149108898 0, 85.1438674926759 22.74211502075201 0, 85.14069366455078 22.738559722900504 0, 85.13050079345714 22.738044738769588 0, 85.12761688232428 22.736465454101562 0, 85.12763977050793 22.731491088867188 0, 85.12924194335938 22.728088378906307 0, 85.12797546386724 22.722576141357365 0, 85.13018798828125 22.720735549926815 0, 85.12989807128912 22.717205047607536 0, 85.1253051757813 22.7138290405274 0, 85.12084197998047 22.70916748046875 0, 85.11975860595709 22.702512741088924 0, 85.1204071044923 22.694818496704215 0, 85.12194824218761 22.688405990600643 0, 85.11804962158209 22.684452056884766 0, 85.11746978759771 22.673974990844783 0, 85.11508941650385 22.668292999267635 0, 85.11377716064453 22.65845108032238 0, 85.09479522705084 22.650989532470817 0, 85.09434509277344 22.64520835876465 0, 85.0916519165039 22.640214920044002 0, 85.08992004394526 22.633207321166992 0, 85.08633422851562 22.62786483764654 0, 85.08180236816412 22.626390457153263 0, 85.07846832275385 22.620986938476676 0, 85.07512664794928 22.6172714233399 0, 85.07534027099615 22.61473464965826 0, 85.08569335937511 22.60877799987793 0, 85.0886001586914 22.605955123901367 0, 85.09505462646496 22.596275329589844 0, 85.09267425537115 22.58701324462902 0, 85.08992767333984 22.58202171325695 0, 85.090103149414 22.575082778930607 0, 85.08737945556652 22.57257843017578 0, 85.07806396484386 22.571203231811523 0, 85.07489013671875 22.57390975952154 0, 85.07234954833996 22.578233718872127 0, 85.06999206542974 22.585281372070426 0, 85.07006835937511 22.59771156311041 0, 85.07086944580078 22.60221672058117 0, 85.06769561767584 22.605386734008903 0, 85.05574035644543 22.608667373657227 0, 85.05424499511713 22.611318588256893 0, 85.05552673339855 22.620983123779354 0, 85.05034637451178 22.634605407714844 0, 85.0547485351563 22.651287078857422 0, 85.05964660644531 22.66392517089838 0, 85.05545806884766 22.668586730957088 0, 85.04899597167974 22.671213150024357 0, 85.04340362548828 22.675117492675895 0, 85.04146575927729 22.681005477905387 0, 85.04796600341797 22.696659088134766 0, 85.0514755249024 22.70889282226574 0, 85.05352020263672 22.718631744384766 0, 85.05672454833979 22.728551864624023 0, 85.05683135986334 22.735382080078182 0, 85.05250549316418 22.74127006530773 0, 85.05020904541027 22.74700736999523 0, 85.04615020751959 22.75292015075695 0, 85.02954864501959 22.754301071166992 0, 85.02329254150402 22.758394241333008 0, 85.01996612548828 22.765054702758732 0, 85.0132293701173 22.767004013061637 0, 85.00863647460949 22.770668029785213 0, 85.00566864013672 22.783250808715877 0, 85.00377655029303 22.785001754760742 0, 85.00000000000006 22.78443717956543 0, 84.99899291992188 22.784286499023438 0, 84.98942565917969 22.785617828369197 0, 84.97688293457037 22.785697937011776 0, 84.97685241699219 22.785697937011776 0, 84.98291015624994 22.79995536804205 0, 84.99901580810553 22.802917480468864 0, 85.00000000000006 22.802818298339844 0, 85.00162506103516 22.802654266357536 0, 85.0052490234375 22.80410957336437 0, 85.0062255859375 22.810428619384822 0, 85.0060653686524 22.817108154296875 0, 85.00327301025402 22.828832626342887 0, 85.00017547607428 22.832427978515682 0, 85.00059509277355 22.83996200561529 0, 85.00000000000006 22.840690612793082 0, 84.99908447265636 22.84180641174322 0, 84.9905395507812 22.858102798462028 0, 84.98575592041027 22.8695964813233 0, 84.9887084960938 22.887554168701115 0, 84.98893737792974 22.89631652832037 0, 84.98668670654308 22.89739227294922 0, 84.9798812866211 22.897737503051815 0, 84.98511505126959 22.91633224487316 0, 84.98845672607422 22.922454833984432 0, 84.99376678466808 22.924964904785213 0, 84.99919891357428 22.923698425292912 0, 85.00000000000006 22.923202514648494 0, 85.00722503662115 22.91872215270996 0, 85.0074920654298 22.912223815918082 0, 85.00939941406261 22.913633346557674 0, 85.01340484619152 22.92378616333002 0, 85.01423645019531 22.928199768066463 0, 85.01307678222656 22.93122482299799 0, 85.01103210449224 22.933734893798828 0, 85.01350402832037 22.94375038146984 0, 85.0127792358399 22.947845458984432 0, 85.00784301757824 22.94739913940441 0, 85.00325012207037 22.945528030395508 0, 85.00000000000006 22.949871063232536 0, 84.99924468994146 22.950874328613338 0, 84.99403381347656 22.954912185669002 0, 84.98922729492188 22.9615154266358 0, 84.98322296142584 22.964811325073356 0, 84.97081756591803 22.967605590820312 0, 84.96205139160162 22.966524124145508 0, 84.950180053711 22.963235855102482 0, 84.94477844238281 22.96551513671875 0, 84.94235992431646 22.97426414489746 0, 84.94091796875011 22.984394073486442 0, 84.94060516357422 22.99533462524414 0, 84.94454956054699 23.000085830688477 0, 84.94396209716808 23.007066726684684 0, 84.94339752197277 23.010549545288143 0, 84.938720703125 23.012943267822322 0, 84.93698120117188 23.016109466552678 0, 84.94203186035162 23.02345085144043 0, 84.94146728515636 23.02530670166027 0, 84.93621063232422 23.029827117920036 0, 84.93335723876953 23.033464431762695 0, 84.93132781982428 23.035087585449162 0, 84.92937469482422 23.03456306457514 0, 84.9299545288086 23.029624938964844 0, 84.92759704589838 23.027919769287223 0, 84.92339324951183 23.02834320068365 0, 84.91882324218744 23.027305603027344 0, 84.9155883789062 23.029201507568416 0, 84.91213226318371 23.03548240661621 0, 84.90964508056652 23.04302787780773 0, 84.90267181396484 23.04858589172369 0, 84.90194702148443 23.055755615234375 0, 84.89513397216808 23.060020446777457 0, 84.87852478027355 23.065504074096793 0, 84.87519836425781 23.068309783935604 0, 84.87435913085949 23.0773983001709 0, 84.87138366699219 23.084886550903434 0, 84.86812591552734 23.090013504028434 0, 84.86721801757818 23.094514846801758 0, 84.86911010742188 23.098411560058537 0, 84.88801574707037 23.100219726562557 0, 84.8927230834961 23.09939384460455 0, 84.89759063720709 23.109670639038086 0, 84.8963394165039 23.111526489257926 0, 84.88830566406244 23.117935180664062 0, 84.88753509521496 23.120527267456055 0, 84.88870239257812 23.130407333373967 0, 84.88539886474621 23.134115219116268 0, 84.88410949707026 23.14059638977062 0, 84.88855743408203 23.15036582946783 0, 84.89025115966797 23.163404464721623 0, 84.89249420166027 23.169725418090877 0, 84.89772796630865 23.17301559448248 0, 84.90466308593761 23.17224884033203 0, 84.91873931884771 23.169067382812557 0, 84.92251586914062 23.17770767211914 0, 84.92349243164068 23.18781089782709 0, 84.91548156738287 23.19060707092285 0, 84.91268157958996 23.192346572875977 0, 84.91185760498053 23.195394515991325 0, 84.91401672363293 23.196245193481502 0, 84.9176712036134 23.196147918701286 0, 84.93440246582037 23.2032413482666 0, 84.93745422363287 23.209287643432674 0, 84.94351196289068 23.210487365722713 0, 84.94907379150396 23.22008705139166 0, 84.94977569580078 23.225563049316463 0, 84.94894409179699 23.228719711303768 0, 84.94291687011719 23.231470108032227 0, 84.93777465820312 23.232242584228516 0, 84.9294891357423 23.237697601318473 0, 84.92142486572271 23.23987770080572 0, 84.91172027587902 23.2443084716798 0, 84.91043090820307 23.250736236572266 0, 84.91350555419922 23.252998352050838 0, 84.91311645507812 23.255306243896484 0, 84.90739440917969 23.258510589599723 0, 84.89958190917969 23.26034736633312 0, 84.8973999023438 23.261585235595646 0, 84.89685821533214 23.2670574188233 0, 84.89794158935553 23.278501510620174 0, 84.9002304077149 23.28590202331543 0, 84.90992736816406 23.297771453857536 0, 84.9208602905274 23.306673049926815 0, 84.92373657226574 23.309444427490348 0, 84.92428588867193 23.311477661132812 0, 84.91825866699213 23.32069396972662 0, 84.9146194458009 23.321178436279354 0, 84.90883636474615 23.327358245849723 0, 84.90309906005865 23.325071334838924 0, 84.89589691162121 23.32063102722168 0, 84.90510559082031 23.343463897705078 0, 84.90302276611328 23.354297637939453 0, 84.90235137939459 23.364799499511776 0, 84.88947296142578 23.370349884033203 0, 84.88568878173828 23.3709011077882 0, 84.88348388671886 23.373043060302734 0, 84.88227844238287 23.37614059448248 0, 84.89263916015636 23.386619567871037 0, 84.88771057128918 23.397222518921012 0, 84.8841781616211 23.402687072753906 0, 84.88446044921886 23.405904769897518 0, 84.88859558105474 23.407548904419002 0, 84.89321899414074 23.411172866821346 0, 84.89663696289068 23.416090011596793 0, 84.89525604248053 23.418575286865234 0, 84.8950805664063 23.42376518249506 0, 84.89407348632812 23.426353454589844 0, 84.89466094970703 23.430137634277344 0, 84.8980712890625 23.436584472656193 0, 84.90341186523438 23.4434814453125 0, 84.90860748291021 23.452123641967887 0, 84.91993713378918 23.461753845214787 0, 84.92449951171886 23.47191619873047 0, 84.92797088623058 23.473112106323356 0, 84.93023681640636 23.47560119628912 0, 84.93372344970703 23.482387542724666 0, 84.93986511230469 23.490354537963867 0, 84.9431838989259 23.501085281372184 0, 84.94203186035162 23.50469970703125 0, 84.9378280639649 23.510047912597656 0, 84.93668365478521 23.519243240356445 0, 84.92431640625011 23.52587509155279 0, 84.91407775878906 23.52697181701666 0, 84.9083480834961 23.538501739502067 0, 84.9060440063476 23.540857315063533 0, 84.89231109619135 23.543670654296932 0, 84.88737487792969 23.55029296875 0, 84.88351440429699 23.552371978759822 0, 84.88420867919928 23.558069229126033 0, 84.89083862304688 23.558092117309684 0, 84.8944320678711 23.559230804443416 0, 84.89987182617193 23.578857421875114 0, 84.90380096435547 23.581979751586857 0, 84.90629577636719 23.579111099243107 0, 84.90653991699224 23.572956085205135 0, 84.90809631347668 23.566303253173885 0, 84.90740203857422 23.55122947692871 0, 84.90793609619152 23.546339035034237 0, 84.9096145629884 23.543525695800838 0, 84.91419219970714 23.543382644653377 0, 84.91844940185541 23.546331405639705 0, 84.9219818115235 23.553283691406364 0, 84.93254852294933 23.55061149597168 0, 84.9339370727539 23.563194274902457 0, 84.93180847167969 23.566909790039062 0, 84.93094635009771 23.572322845458984 0, 84.93234252929699 23.57740020751953 0, 84.9419174194336 23.601070404052848 0, 84.9434051513673 23.608179092407283 0, 84.94031524658209 23.62075424194336 0, 84.94060516357422 23.632944107055664 0, 84.94001007080078 23.63672256469738 0, 84.92028808593756 23.64682579040533 0, 84.91790771484375 23.649469375610465 0, 84.91719055175787 23.65308380126953 0, 84.92220306396496 23.664482116699332 0, 84.92044067382818 23.667417526245174 0, 84.92091369628918 23.669839859008846 0, 84.92461395263672 23.67514801025402 0, 84.93352508544922 23.681875228881836 0, 84.931869506836 23.68779373168951 0, 84.93291473388683 23.69134712219244 0, 84.939926147461 23.69440650939947 0, 84.94213104248047 23.697847366333065 0, 84.94714355468756 23.701923370361385 0, 84.95469665527344 23.69770622253418 0, 84.95999145507824 23.69608497619629 0, 84.96249389648449 23.70201301574707 0, 84.96345520019526 23.7071990966798 0, 84.96174621582026 23.71431541442871 0, 84.96650695800776 23.71555900573742 0, 84.97035217285156 23.715234756469783 0, 84.97382354736328 23.70835876464855 0, 84.97650909423834 23.706502914428768 0, 84.98553466796886 23.70399665832531 0, 84.98744201660168 23.700496673583984 0))",both
KHUNTI,530299,265939,264360,215,,left_only
GUMLA,1025656,514730,510926,193,"POLYGON Z ((84.35726928710949 23.609262466430664 0, 84.37426757812511 23.60548019409174 0, 84.37995910644543 23.608118057250977 0, 84.39131927490234 23.60384178161621 0, 84.39695739746105 23.6047306060791 0, 84.4053421020509 23.600555419921932 0, 84.44020843505865 23.58920860290533 0, 84.44381713867193 23.59402275085455 0, 84.44760894775396 23.593769073486385 0, 84.44931793212896 23.595529556274414 0, 84.4511184692384 23.596107482910156 0, 84.45195007324219 23.593626022338924 0, 84.44994354248058 23.585489273071346 0, 84.46109771728516 23.582960128784237 0, 84.46628570556646 23.579662322998104 0, 84.46893310546875 23.576517105102596 0, 84.46833038330078 23.570363998413143 0, 84.46052551269531 23.539566040039176 0, 84.4600219726563 23.53465652465826 0, 84.46068572998041 23.530757904052734 0, 84.46756744384766 23.521381378173828 0, 84.46870422363281 23.514898300171012 0, 84.46752166748058 23.50558090209961 0, 84.46791839599621 23.498703002929744 0, 84.47338104248053 23.488180160522575 0, 84.47272491455078 23.48574829101574 0, 84.46685028076172 23.478494644165096 0, 84.46201324462885 23.468303680420036 0, 84.4592056274414 23.465299606323356 0, 84.45531463623058 23.463356018066406 0, 84.45034790039074 23.45892333984375 0, 84.44609069824224 23.456476211547795 0, 84.4402847290039 23.445039749145508 0, 84.42598724365234 23.432880401611328 0, 84.42316436767578 23.430042266845703 0, 84.42195892333979 23.426929473877067 0, 84.43191528320312 23.41492080688488 0, 84.4417114257813 23.40555381774908 0, 84.44495391845709 23.40388107299799 0, 84.44979095458996 23.403461456298942 0, 84.46139526367199 23.4084415435791 0, 84.47341918945324 23.404058456421012 0, 84.47898864746088 23.39540290832531 0, 84.47522735595703 23.392608642578182 0, 84.47132873535168 23.387735366821346 0, 84.47160339355469 23.37492942810053 0, 84.47079467773432 23.370521545410213 0, 84.47315216064459 23.365520477295036 0, 84.47741699218761 23.36068916320812 0, 84.48447418212902 23.35672569274908 0, 84.49069976806646 23.354393005371094 0, 84.49797821044928 23.352966308593807 0, 84.49930572509771 23.355680465698242 0, 84.49927520751953 23.36780929565441 0, 84.50046539306646 23.37233161926281 0, 84.50315093994146 23.37624740600586 0, 84.51123809814453 23.384578704834098 0, 84.51782989501959 23.38236236572277 0, 84.51955413818365 23.378824234008903 0, 84.5185317993164 23.370347976684627 0, 84.52416229248058 23.36632347106945 0, 84.53639221191418 23.34900856018072 0, 84.5431747436524 23.346057891845817 0, 84.55085754394543 23.347055435180664 0, 84.55530548095703 23.348545074463004 0, 84.56002044677746 23.348743438720646 0, 84.56474304199224 23.34702491760254 0, 84.57099914550787 23.342599868774357 0, 84.57655334472662 23.33269691467285 0, 84.5877685546875 23.32254219055187 0, 84.59436798095714 23.320146560668945 0, 84.60598754882824 23.317386627197322 0, 84.61325073242199 23.321933746337947 0, 84.61661529541021 23.319868087768555 0, 84.62064361572271 23.315027236938533 0, 84.62671661376959 23.309535980224666 0, 84.63379669189459 23.307874679565487 0, 84.64276885986334 23.308759689331055 0, 84.64905548095709 23.31257438659668 0, 84.65719604492188 23.30996513366705 0, 84.66226196289074 23.316184997558707 0, 84.66914367675793 23.316839218139705 0, 84.67276000976574 23.32063484191906 0, 84.6761093139649 23.320484161377067 0, 84.6792984008789 23.31785011291504 0, 84.68313598632812 23.3178653717041 0, 84.6861572265625 23.313592910766715 0, 84.6904754638673 23.31022071838379 0, 84.69635772705084 23.310134887695256 0, 84.703598022461 23.311185836792106 0, 84.70934295654308 23.31244659423828 0, 84.7142105102539 23.32122039794922 0, 84.73381042480463 23.332244873046818 0, 84.74367523193371 23.331892013549805 0, 84.74826812744152 23.32456970214855 0, 84.7520141601563 23.322052001953182 0, 84.76931762695312 23.320081710815487 0, 84.77837371826178 23.32028388977045 0, 84.7851791381836 23.3217830657959 0, 84.78620147705084 23.317720413208065 0, 84.7901382446289 23.315143585205192 0, 84.79071044921875 23.312719345092887 0, 84.78652954101568 23.297075271606445 0, 84.78473663330072 23.28375434875494 0, 84.78543853759771 23.28183364868164 0, 84.78699493408214 23.280544281005916 0, 84.79010009765625 23.280441284179688 0, 84.8025512695313 23.281896591186523 0, 84.81082916259777 23.284011840820312 0, 84.81222534179688 23.286390304565543 0, 84.81408691406261 23.293500900268555 0, 84.81549835205078 23.29485702514654 0, 84.818588256836 23.295831680297965 0, 84.8257293701173 23.296077728271598 0, 84.8365097045899 23.297912597656193 0, 84.84039306640636 23.301532745361385 0, 84.84290313720714 23.30548286437994 0, 84.84378814697271 23.31112098693842 0, 84.84637451171875 23.31423187255865 0, 84.84976959228527 23.316490173339844 0, 84.86227416992193 23.31669044494629 0, 84.86717987060547 23.314838409423828 0, 84.87258148193365 23.31153106689453 0, 84.88212585449224 23.31663894653326 0, 84.8888626098634 23.317680358886776 0, 84.89589691162121 23.32063102722168 0, 84.90309906005865 23.325071334838924 0, 84.90883636474615 23.327358245849723 0, 84.9146194458009 23.321178436279354 0, 84.91825866699213 23.32069396972662 0, 84.92428588867193 23.311477661132812 0, 84.92373657226574 23.309444427490348 0, 84.9208602905274 23.306673049926815 0, 84.90992736816406 23.297771453857536 0, 84.9002304077149 23.28590202331543 0, 84.89794158935553 23.278501510620174 0, 84.89685821533214 23.2670574188233 0, 84.8973999023438 23.261585235595646 0, 84.89958190917969 23.26034736633312 0, 84.90739440917969 23.258510589599723 0, 84.91311645507812 23.255306243896484 0, 84.91350555419922 23.252998352050838 0, 84.91043090820307 23.250736236572266 0, 84.91172027587902 23.2443084716798 0, 84.92142486572271 23.23987770080572 0, 84.9294891357423 23.237697601318473 0, 84.93777465820312 23.232242584228516 0, 84.94291687011719 23.231470108032227 0, 84.94894409179699 23.228719711303768 0, 84.94977569580078 23.225563049316463 0, 84.94907379150396 23.22008705139166 0, 84.94351196289068 23.210487365722713 0, 84.93745422363287 23.209287643432674 0, 84.93440246582037 23.2032413482666 0, 84.9176712036134 23.196147918701286 0, 84.91401672363293 23.196245193481502 0, 84.91185760498053 23.195394515991325 0, 84.91268157958996 23.192346572875977 0, 84.91548156738287 23.19060707092285 0, 84.92349243164068 23.18781089782709 0, 84.92251586914062 23.17770767211914 0, 84.91873931884771 23.169067382812557 0, 84.90466308593761 23.17224884033203 0, 84.89772796630865 23.17301559448248 0, 84.89249420166027 23.169725418090877 0, 84.89025115966797 23.163404464721623 0, 84.88855743408203 23.15036582946783 0, 84.88410949707026 23.14059638977062 0, 84.88539886474621 23.134115219116268 0, 84.88870239257812 23.130407333373967 0, 84.88753509521496 23.120527267456055 0, 84.88830566406244 23.117935180664062 0, 84.8963394165039 23.111526489257926 0, 84.89759063720709 23.109670639038086 0, 84.8927230834961 23.09939384460455 0, 84.88801574707037 23.100219726562557 0, 84.86911010742188 23.098411560058537 0, 84.86721801757818 23.094514846801758 0, 84.86812591552734 23.090013504028434 0, 84.87138366699219 23.084886550903434 0, 84.87435913085949 23.0773983001709 0, 84.87519836425781 23.068309783935604 0, 84.87852478027355 23.065504074096793 0, 84.89513397216808 23.060020446777457 0, 84.90194702148443 23.055755615234375 0, 84.90267181396484 23.04858589172369 0, 84.90964508056652 23.04302787780773 0, 84.91213226318371 23.03548240661621 0, 84.9155883789062 23.029201507568416 0, 84.91882324218744 23.027305603027344 0, 84.92339324951183 23.02834320068365 0, 84.92759704589838 23.027919769287223 0, 84.9299545288086 23.029624938964844 0, 84.92937469482422 23.03456306457514 0, 84.93132781982428 23.035087585449162 0, 84.93335723876953 23.033464431762695 0, 84.93621063232422 23.029827117920036 0, 84.94146728515636 23.02530670166027 0, 84.94203186035162 23.02345085144043 0, 84.93698120117188 23.016109466552678 0, 84.938720703125 23.012943267822322 0, 84.94339752197277 23.010549545288143 0, 84.94396209716808 23.007066726684684 0, 84.94454956054699 23.000085830688477 0, 84.94060516357422 22.99533462524414 0, 84.94091796875011 22.984394073486442 0, 84.94235992431646 22.97426414489746 0, 84.94477844238281 22.96551513671875 0, 84.950180053711 22.963235855102482 0, 84.96205139160162 22.966524124145508 0, 84.97081756591803 22.967605590820312 0, 84.98322296142584 22.964811325073356 0, 84.98922729492188 22.9615154266358 0, 84.99403381347656 22.954912185669002 0, 84.99924468994146 22.950874328613338 0, 85.00000000000006 22.949871063232536 0, 85.00325012207037 22.945528030395508 0, 85.00784301757824 22.94739913940441 0, 85.0127792358399 22.947845458984432 0, 85.01350402832037 22.94375038146984 0, 85.01103210449224 22.933734893798828 0, 85.01307678222656 22.93122482299799 0, 85.01423645019531 22.928199768066463 0, 85.01340484619152 22.92378616333002 0, 85.00939941406261 22.913633346557674 0, 85.0074920654298 22.912223815918082 0, 85.00722503662115 22.91872215270996 0, 85.00000000000006 22.923202514648494 0, 84.99919891357428 22.923698425292912 0, 84.99376678466808 22.924964904785213 0, 84.98845672607422 22.922454833984432 0, 84.98511505126959 22.91633224487316 0, 84.9798812866211 22.897737503051815 0, 84.98668670654308 22.89739227294922 0, 84.98893737792974 22.89631652832037 0, 84.9887084960938 22.887554168701115 0, 84.98575592041027 22.8695964813233 0, 84.9905395507812 22.858102798462028 0, 84.99908447265636 22.84180641174322 0, 85.00000000000006 22.840690612793082 0, 85.00059509277355 22.83996200561529 0, 85.00017547607428 22.832427978515682 0, 85.00327301025402 22.828832626342887 0, 85.0060653686524 22.817108154296875 0, 85.0062255859375 22.810428619384822 0, 85.0052490234375 22.80410957336437 0, 85.00162506103516 22.802654266357536 0, 85.00000000000006 22.802818298339844 0, 84.99901580810553 22.802917480468864 0, 84.98291015624994 22.79995536804205 0, 84.97685241699219 22.785697937011776 0, 84.97688293457037 22.785697937011776 0, 84.96654510498047 22.782814025878906 0, 84.96163940429693 22.779195785522518 0, 84.95563507080072 22.775522232055778 0, 84.94989013671886 22.775985717773494 0, 84.94481658935547 22.778455734253043 0, 84.93108367919922 22.79106330871582 0, 84.92632293701172 22.788545608520508 0, 84.92102050781256 22.782268524169865 0, 84.91780090332037 22.768184661865234 0, 84.91088867187506 22.76122283935547 0, 84.90348815917974 22.76007843017578 0, 84.89962768554688 22.757623672485295 0, 84.89894866943371 22.752855300903263 0, 84.89572906494152 22.749181747436523 0, 84.88901519775402 22.74497604370123 0, 84.88156890869146 22.742359161377067 0, 84.8755264282226 22.745409011840763 0, 84.87264251708996 22.753240585327205 0, 84.86737060546875 22.755805969238395 0, 84.86148071289062 22.757743835449332 0, 84.85854339599621 22.76410293579113 0, 84.85181427001959 22.767635345458984 0, 84.84534454345714 22.769960403442496 0, 84.84186553955084 22.767124176025447 0, 84.84111785888678 22.76042175292963 0, 84.84230804443371 22.752368927001953 0, 84.8484878540039 22.742130279541072 0, 84.85586547851574 22.732221603393555 0, 84.85594177246094 22.72364997863781 0, 84.8536376953125 22.720315933227596 0, 84.8479232788086 22.721694946289176 0, 84.83802032470703 22.727724075317383 0, 84.83301544189453 22.732120513916016 0, 84.83209228515625 22.736572265625114 0, 84.82892608642584 22.742200851440487 0, 84.82215881347656 22.74739074707037 0, 84.8175430297851 22.7459716796875 0, 84.81385040283209 22.740100860595817 0, 84.81522369384777 22.73167228698736 0, 84.81847381591808 22.720146179199332 0, 84.8181381225586 22.71380043029785 0, 84.81271362304693 22.7092742919923 0, 84.80355834960943 22.71158981323248 0, 84.79821014404303 22.71194458007824 0, 84.79504394531244 22.717662811279297 0, 84.79109191894531 22.718156814575195 0, 84.78707122802734 22.722152709960938 0, 84.7871780395509 22.73062515258789 0, 84.79087829589844 22.746551513671875 0, 84.79272460937511 22.754495620727596 0, 84.79206848144537 22.77183532714855 0, 84.78728485107422 22.771341323852482 0, 84.7851791381836 22.768276214599666 0, 84.78334808349621 22.75893592834484 0, 84.77625274658209 22.763214111328182 0, 84.77473449707037 22.7814102172851 0, 84.77966308593756 22.791204452514705 0, 84.77001190185558 22.790437698364258 0, 84.7633514404298 22.79070472717291 0, 84.75548553466803 22.792976379394588 0, 84.74983215332026 22.795307159423828 0, 84.73590087890636 22.801052093505916 0, 84.73046875000006 22.801773071289176 0, 84.7266464233399 22.797746658325252 0, 84.72341918945318 22.791120529174805 0, 84.71691894531256 22.78717803955078 0, 84.71715545654303 22.782749176025447 0, 84.72085571289062 22.783279418945426 0, 84.72074127197271 22.780149459838924 0, 84.72501373291027 22.77467346191412 0, 84.72695922851562 22.773508071899414 0, 84.72327423095714 22.765054702758732 0, 84.70891571044928 22.766328811645565 0, 84.70095062255871 22.763076782226676 0, 84.697998046875 22.758192062377987 0, 84.69709014892584 22.752325057983512 0, 84.69764709472662 22.748622894287166 0, 84.69424438476568 22.74237060546875 0, 84.67714691162121 22.7364501953125 0, 84.66847229003912 22.73828315734869 0, 84.66715240478521 22.734638214111328 0, 84.66338348388683 22.72913551330572 0, 84.65760040283209 22.728483200073356 0, 84.6517944335937 22.732898712158203 0, 84.64875030517572 22.739440917968693 0, 84.64436340332026 22.73321914672863 0, 84.6352310180664 22.730642318725586 0, 84.62047576904308 22.73173713684082 0, 84.60513305664062 22.730360031127987 0, 84.6028900146485 22.72600746154785 0, 84.60386657714855 22.722660064697322 0, 84.59130859375011 22.71281623840332 0, 84.58518981933605 22.714014053344783 0, 84.5810012817384 22.718723297119254 0, 84.5780258178711 22.72205924987793 0, 84.57191467285156 22.726297378540153 0, 84.56770324707031 22.727806091308537 0, 84.55742645263672 22.729312896728516 0, 84.56012725830084 22.73273277282709 0, 84.56204986572271 22.739398956298828 0, 84.56649780273449 22.744607925415153 0, 84.56052398681646 22.7469997406007 0, 84.55178833007818 22.75859260559082 0, 84.54618835449219 22.763181686401424 0, 84.54161834716797 22.763042449951172 0, 84.53867340087902 22.761287689208928 0, 84.53769683837902 22.750263214111328 0, 84.53583526611322 22.745344161987305 0, 84.52930450439464 22.74323463439947 0, 84.52877807617182 22.73947334289562 0, 84.52391815185553 22.742567062377987 0, 84.51925659179688 22.748416900634822 0, 84.51503753662104 22.755544662475643 0, 84.51927185058594 22.760393142700252 0, 84.52536010742188 22.761224746704215 0, 84.53128051757812 22.765747070312614 0, 84.5365447998048 22.76568031311035 0, 84.54771423339844 22.767097473144474 0, 84.55201721191418 22.77065277099615 0, 84.55545806884777 22.778196334838924 0, 84.5538101196289 22.787918090820312 0, 84.54868316650396 22.791940689086857 0, 84.53068542480463 22.791650772094783 0, 84.52584838867193 22.795387268066406 0, 84.50143432617193 22.796112060546875 0, 84.50302124023432 22.821952819824276 0, 84.4734878540039 22.83314132690441 0, 84.46338653564453 22.834083557128906 0, 84.45549774169933 22.835882186889762 0, 84.44988250732428 22.83438873291027 0, 84.44920349121105 22.831920623779297 0, 84.44935607910162 22.813123703002987 0, 84.44373321533203 22.808589935302678 0, 84.4385223388673 22.807359695434684 0, 84.42758941650396 22.810073852539062 0, 84.43231201171875 22.79989624023449 0, 84.43196105957037 22.79262924194336 0, 84.41988372802734 22.779254913330078 0, 84.4163436889649 22.765630722045955 0, 84.4141845703125 22.763391494750977 0, 84.41022491455084 22.76387596130371 0, 84.4046401977539 22.76891899108898 0, 84.40044403076172 22.774200439453125 0, 84.39337158203125 22.77366828918457 0, 84.38887023925787 22.772691726684513 0, 84.3905868530274 22.76757621765148 0, 84.38771057128912 22.764711380004883 0, 84.37948608398438 22.762462615966797 0, 84.3748779296875 22.75835800170904 0, 84.37194061279308 22.75365257263195 0, 84.3666229248048 22.754909515380916 0, 84.36089324951183 22.75725555419922 0, 84.3511352539063 22.761249542236442 0, 84.34889984130871 22.75965690612793 0, 84.35337066650396 22.75068473815918 0, 84.34906005859386 22.746662139892578 0, 84.33794403076178 22.746704101562443 0, 84.33187866210949 22.75544548034668 0, 84.32546997070312 22.762905120849666 0, 84.32075500488287 22.76451301574707 0, 84.3195266723634 22.764646530151367 0, 84.31382751464844 22.76526260375988 0, 84.29263305664074 22.773324966430664 0, 84.29260253906261 22.77333831787115 0, 84.29202270507824 22.77913093566906 0, 84.2952270507813 22.78956031799322 0, 84.3011932373048 22.796028137207088 0, 84.30673217773449 22.797472000122013 0, 84.30837249755865 22.80086326599121 0, 84.3148803710938 22.801372528076172 0, 84.3165893554688 22.80569267272955 0, 84.3174285888673 22.812734603881893 0, 84.32260131835938 22.81956100463873 0, 84.32528686523438 22.838378906250057 0, 84.32350921630871 22.83747673034668 0, 84.3233108520509 22.84609031677246 0, 84.32521820068371 22.85174369812006 0, 84.33437347412121 22.86187171936041 0, 84.33990478515636 22.862558364868164 0, 84.34326934814459 22.86136436462408 0, 84.34707641601568 22.86149978637701 0, 84.35277557373047 22.865482330322266 0, 84.36281585693371 22.862932205200195 0, 84.37477111816412 22.866844177246207 0, 84.3748245239259 22.871244430541992 0, 84.37635040283214 22.87446403503418 0, 84.380844116211 22.87596702575678 0, 84.38180541992193 22.87821769714367 0, 84.38076782226557 22.883720397949276 0, 84.38306427001953 22.890171051025504 0, 84.38313293457037 22.895435333251953 0, 84.381591796875 22.90001869201666 0, 84.37767028808605 22.900695800781307 0, 84.37575531005871 22.903903961181754 0, 84.38108062744146 22.911472320556697 0, 84.39118957519537 22.91910552978527 0, 84.39453887939453 22.92600631713873 0, 84.39393615722656 22.94098854064947 0, 84.39134979248053 22.944612503051815 0, 84.38684844970714 22.94796180725092 0, 84.38413238525396 22.95111656188959 0, 84.3826904296875 22.954132080078182 0, 84.38264465332043 22.963911056518555 0, 84.38128662109386 22.968492507934627 0, 84.3782958984375 22.974313735961914 0, 84.37545013427734 22.97723960876459 0, 84.36640930175793 22.976709365844783 0, 84.35315704345703 22.978019714355582 0, 84.34851837158214 22.975872039794865 0, 84.33673095703125 22.981266021728516 0, 84.33010101318365 22.981460571289176 0, 84.32318115234375 22.97870254516613 0, 84.31942749023443 22.974357604980526 0, 84.31168365478527 22.96963882446289 0, 84.29428863525396 22.963760375976506 0, 84.28353118896484 22.963361740112305 0, 84.27690124511724 22.973035812378043 0, 84.27385711669928 22.981113433837947 0, 84.27607727050781 22.98623657226574 0, 84.27637481689464 22.99092102050787 0, 84.27286529541016 22.98996925354004 0, 84.26705169677746 22.982118606567326 0, 84.2595901489259 22.97578239440918 0, 84.2558822631836 22.97350692749029 0, 84.24649047851557 22.974943161010856 0, 84.24240112304693 22.98245429992687 0, 84.23181915283203 22.982114791870174 0, 84.22206115722668 22.978517532348633 0, 84.21992492675793 22.979469299316463 0, 84.21701049804693 22.988416671752987 0, 84.20606994628906 23.000814437866268 0, 84.20181274414074 23.006078720092773 0, 84.20494079589844 23.017093658447266 0, 84.20327758789068 23.02094841003418 0, 84.19496154785168 23.025663375854606 0, 84.18407440185558 23.024503707885856 0, 84.1817245483399 23.022457122802734 0, 84.180404663086 23.01385688781744 0, 84.17764282226562 23.00916290283203 0, 84.17898559570312 23.002309799194393 0, 84.17818450927746 23.000719070434627 0, 84.17363739013672 22.99697303771984 0, 84.1756210327149 22.987190246582145 0, 84.17639160156256 22.979085922241268 0, 84.17288970947266 22.972974777221737 0, 84.15962219238287 22.966386795044002 0, 84.15304565429688 22.96586990356451 0, 84.14861297607433 22.977094650268555 0, 84.15015411376964 22.984550476074162 0, 84.14925384521484 22.99015235900879 0, 84.14342498779303 23.00043106079113 0, 84.14237976074219 23.008209228515625 0, 84.13675689697277 23.020156860351676 0, 84.13170623779297 23.027908325195312 0, 84.12967681884771 23.03263473510748 0, 84.12873840332037 23.038494110107422 0, 84.12843322753906 23.046852111816463 0, 84.12989807128918 23.05533027648937 0, 84.13095092773438 23.0587215423584 0, 84.13584136962902 23.065200805664176 0, 84.13677978515636 23.06926727294922 0, 84.13599395751964 23.079307556152457 0, 84.13444519042974 23.083353042602653 0, 84.13154602050787 23.086948394775447 0, 84.12126159667974 23.087930679321403 0, 84.11753845214855 23.08896827697754 0, 84.11534881591803 23.093862533569393 0, 84.11003112792974 23.100988388061637 0, 84.10245513916027 23.106563568115234 0, 84.09297180175781 23.111217498779354 0, 84.08157348632818 23.111576080322322 0, 84.07183837890625 23.108833312988338 0, 84.0665969848634 23.111612319946232 0, 84.06406402587896 23.114297866821232 0, 84.06071472167963 23.122392654419002 0, 84.05799102783214 23.126150131225643 0, 84.05039978027355 23.13217353820812 0, 84.04512023925781 23.133766174316406 0, 84.04109954833984 23.136598587036076 0, 84.038818359375 23.140083312988338 0, 84.03849792480474 23.14436149597168 0, 84.03541564941412 23.15099525451666 0, 84.03423309326172 23.155496597289982 0, 84.03627777099621 23.16273689270014 0, 84.03896331787104 23.169441223144588 0, 84.03996276855469 23.171379089355526 0, 84.04446411132824 23.180105209350643 0, 84.04911804199219 23.18618583679205 0, 84.05603790283209 23.19115447998047 0, 84.06124877929699 23.19798278808588 0, 84.06349182128912 23.205163955688533 0, 84.0631790161134 23.209562301635685 0, 84.05875396728527 23.214714050293082 0, 84.05752563476562 23.21796989440918 0, 84.05739593505865 23.222770690917912 0, 84.05916595458996 23.23570251464855 0, 84.05559539794922 23.242446899414062 0, 84.05642700195318 23.248090744018498 0, 84.06423950195318 23.275585174560604 0, 84.06423187255865 23.283763885498047 0, 84.06522369384771 23.287727355957088 0, 84.06820678710938 23.291074752807617 0, 84.06897735595703 23.293680191040096 0, 84.06456756591797 23.305713653564453 0, 84.06513214111328 23.309610366821232 0, 84.07543182373047 23.331369400024414 0, 84.07666015625006 23.331260681152457 0, 84.09555053710943 23.329593658447322 0, 84.10007476806646 23.337532043457088 0, 84.10734558105474 23.340747833251896 0, 84.11389160156261 23.34255409240734 0, 84.11540985107433 23.34466171264654 0, 84.1169815063476 23.35076522827154 0, 84.12667846679699 23.345149993896484 0, 84.13082885742193 23.345468521118107 0, 84.13523864746105 23.340250015258846 0, 84.13942718505871 23.338201522827205 0, 84.16519927978527 23.331079483032283 0, 84.1923065185548 23.32498168945324 0, 84.19465637207031 23.32562255859375 0, 84.19989013671886 23.336210250854435 0, 84.20414733886713 23.33777046203619 0, 84.22518157958984 23.340751647949276 0, 84.22818756103516 23.34325981140131 0, 84.24179840087896 23.34905624389654 0, 84.24445343017578 23.35370254516596 0, 84.2501220703125 23.36966133117687 0, 84.25861358642584 23.378746032714957 0, 84.25760650634766 23.38410377502447 0, 84.25147247314453 23.402225494384766 0, 84.2507095336914 23.407798767089844 0, 84.25138092041021 23.412208557128906 0, 84.2535629272461 23.416118621826172 0, 84.25428009033214 23.422269821166992 0, 84.25245666503906 23.428356170654297 0, 84.24707794189453 23.44033432006836 0, 84.24762725830072 23.44591712951666 0, 84.24996185302734 23.451858520507812 0, 84.25799560546875 23.458131790161246 0, 84.2676239013673 23.462316513061523 0, 84.2754364013673 23.467229843139762 0, 84.27570343017578 23.470394134521598 0, 84.2829360961914 23.476703643798942 0, 84.28695678710938 23.491176605224723 0, 84.28865814208984 23.493446350097656 0, 84.29115295410156 23.492790222168026 0, 84.30330657958996 23.484411239623967 0, 84.31523132324224 23.483539581298885 0, 84.31506347656256 23.49166488647461 0, 84.31566619873058 23.492853164672965 0, 84.32489013671875 23.49495124816906 0, 84.32556915283209 23.499912261962947 0, 84.32479858398443 23.511032104492188 0, 84.32321166992188 23.51784324645996 0, 84.32654571533214 23.528532028198242 0, 84.32479858398443 23.538227081298885 0, 84.32444000244152 23.551311492919865 0, 84.32348632812511 23.557624816894588 0, 84.31785583496094 23.574628829955998 0, 84.31716156005865 23.579132080078125 0, 84.33307647705072 23.58320045471197 0, 84.33894348144543 23.585773468017635 0, 84.34213256835943 23.588792800903434 0, 84.33918762207026 23.59983062744152 0, 84.34339904785156 23.60103797912592 0, 84.34924316406261 23.605316162109432 0, 84.3544921875 23.607213973999137 0, 84.35726928710949 23.609262466430664 0))",both
SIMDEGA,599813,299905,299908,160,"POLYGON Z ((84.50302124023432 22.821952819824276 0, 84.50143432617193 22.796112060546875 0, 84.52584838867193 22.795387268066406 0, 84.53068542480463 22.791650772094783 0, 84.54868316650396 22.791940689086857 0, 84.5538101196289 22.787918090820312 0, 84.55545806884777 22.778196334838924 0, 84.55201721191418 22.77065277099615 0, 84.54771423339844 22.767097473144474 0, 84.5365447998048 22.76568031311035 0, 84.53128051757812 22.765747070312614 0, 84.52536010742188 22.761224746704215 0, 84.51927185058594 22.760393142700252 0, 84.51503753662104 22.755544662475643 0, 84.51925659179688 22.748416900634822 0, 84.52391815185553 22.742567062377987 0, 84.52877807617182 22.73947334289562 0, 84.52930450439464 22.74323463439947 0, 84.53583526611322 22.745344161987305 0, 84.53769683837902 22.750263214111328 0, 84.53867340087902 22.761287689208928 0, 84.54161834716797 22.763042449951172 0, 84.54618835449219 22.763181686401424 0, 84.55178833007818 22.75859260559082 0, 84.56052398681646 22.7469997406007 0, 84.56649780273449 22.744607925415153 0, 84.56204986572271 22.739398956298828 0, 84.56012725830084 22.73273277282709 0, 84.55742645263672 22.729312896728516 0, 84.56770324707031 22.727806091308537 0, 84.57191467285156 22.726297378540153 0, 84.5780258178711 22.72205924987793 0, 84.5810012817384 22.718723297119254 0, 84.58518981933605 22.714014053344783 0, 84.59130859375011 22.71281623840332 0, 84.60386657714855 22.722660064697322 0, 84.6028900146485 22.72600746154785 0, 84.60513305664062 22.730360031127987 0, 84.62047576904308 22.73173713684082 0, 84.6352310180664 22.730642318725586 0, 84.64436340332026 22.73321914672863 0, 84.64875030517572 22.739440917968693 0, 84.6517944335937 22.732898712158203 0, 84.65760040283209 22.728483200073356 0, 84.66338348388683 22.72913551330572 0, 84.66715240478521 22.734638214111328 0, 84.66847229003912 22.73828315734869 0, 84.67714691162121 22.7364501953125 0, 84.69424438476568 22.74237060546875 0, 84.69764709472662 22.748622894287166 0, 84.69709014892584 22.752325057983512 0, 84.697998046875 22.758192062377987 0, 84.70095062255871 22.763076782226676 0, 84.70891571044928 22.766328811645565 0, 84.72327423095714 22.765054702758732 0, 84.72695922851562 22.773508071899414 0, 84.72501373291027 22.77467346191412 0, 84.72074127197271 22.780149459838924 0, 84.72085571289062 22.783279418945426 0, 84.71715545654303 22.782749176025447 0, 84.71691894531256 22.78717803955078 0, 84.72341918945318 22.791120529174805 0, 84.7266464233399 22.797746658325252 0, 84.73046875000006 22.801773071289176 0, 84.73590087890636 22.801052093505916 0, 84.74983215332026 22.795307159423828 0, 84.75548553466803 22.792976379394588 0, 84.7633514404298 22.79070472717291 0, 84.77001190185558 22.790437698364258 0, 84.77966308593756 22.791204452514705 0, 84.77473449707037 22.7814102172851 0, 84.77625274658209 22.763214111328182 0, 84.78334808349621 22.75893592834484 0, 84.7851791381836 22.768276214599666 0, 84.78728485107422 22.771341323852482 0, 84.79206848144537 22.77183532714855 0, 84.79272460937511 22.754495620727596 0, 84.79087829589844 22.746551513671875 0, 84.7871780395509 22.73062515258789 0, 84.78707122802734 22.722152709960938 0, 84.79109191894531 22.718156814575195 0, 84.79504394531244 22.717662811279297 0, 84.79821014404303 22.71194458007824 0, 84.80355834960943 22.71158981323248 0, 84.81271362304693 22.7092742919923 0, 84.8181381225586 22.71380043029785 0, 84.81847381591808 22.720146179199332 0, 84.81522369384777 22.73167228698736 0, 84.81385040283209 22.740100860595817 0, 84.8175430297851 22.7459716796875 0, 84.82215881347656 22.74739074707037 0, 84.82892608642584 22.742200851440487 0, 84.83209228515625 22.736572265625114 0, 84.83301544189453 22.732120513916016 0, 84.83802032470703 22.727724075317383 0, 84.8479232788086 22.721694946289176 0, 84.8536376953125 22.720315933227596 0, 84.85594177246094 22.72364997863781 0, 84.85586547851574 22.732221603393555 0, 84.8484878540039 22.742130279541072 0, 84.84230804443371 22.752368927001953 0, 84.84111785888678 22.76042175292963 0, 84.84186553955084 22.767124176025447 0, 84.84534454345714 22.769960403442496 0, 84.85181427001959 22.767635345458984 0, 84.85854339599621 22.76410293579113 0, 84.86148071289062 22.757743835449332 0, 84.86737060546875 22.755805969238395 0, 84.87264251708996 22.753240585327205 0, 84.8755264282226 22.745409011840763 0, 84.88156890869146 22.742359161377067 0, 84.88901519775402 22.74497604370123 0, 84.89572906494152 22.749181747436523 0, 84.89894866943371 22.752855300903263 0, 84.89962768554688 22.757623672485295 0, 84.90348815917974 22.76007843017578 0, 84.91088867187506 22.76122283935547 0, 84.91780090332037 22.768184661865234 0, 84.92102050781256 22.782268524169865 0, 84.92632293701172 22.788545608520508 0, 84.93108367919922 22.79106330871582 0, 84.94481658935547 22.778455734253043 0, 84.94989013671886 22.775985717773494 0, 84.95563507080072 22.775522232055778 0, 84.96163940429693 22.779195785522518 0, 84.96654510498047 22.782814025878906 0, 84.97688293457037 22.785697937011776 0, 84.98942565917969 22.785617828369197 0, 84.99899291992188 22.784286499023438 0, 85.00000000000006 22.78443717956543 0, 85.00377655029303 22.785001754760742 0, 85.00566864013672 22.783250808715877 0, 85.00863647460949 22.770668029785213 0, 85.0132293701173 22.767004013061637 0, 85.01996612548828 22.765054702758732 0, 85.02329254150402 22.758394241333008 0, 85.02954864501959 22.754301071166992 0, 85.04615020751959 22.75292015075695 0, 85.05020904541027 22.74700736999523 0, 85.05250549316418 22.74127006530773 0, 85.05683135986334 22.735382080078182 0, 85.05672454833979 22.728551864624023 0, 85.05352020263672 22.718631744384766 0, 85.0514755249024 22.70889282226574 0, 85.04796600341797 22.696659088134766 0, 85.04146575927729 22.681005477905387 0, 85.04340362548828 22.675117492675895 0, 85.04899597167974 22.671213150024357 0, 85.05545806884766 22.668586730957088 0, 85.05964660644531 22.66392517089838 0, 85.0547485351563 22.651287078857422 0, 85.05034637451178 22.634605407714844 0, 85.05552673339855 22.620983123779354 0, 85.05424499511713 22.611318588256893 0, 85.05574035644543 22.608667373657227 0, 85.06769561767584 22.605386734008903 0, 85.07086944580078 22.60221672058117 0, 85.07006835937511 22.59771156311041 0, 85.06999206542974 22.585281372070426 0, 85.07234954833996 22.578233718872127 0, 85.07489013671875 22.57390975952154 0, 85.07806396484386 22.571203231811523 0, 85.07395935058594 22.56729698181158 0, 85.06990814208984 22.565187454223633 0, 85.0679397583009 22.560892105102596 0, 85.07100677490246 22.549556732177848 0, 85.07051086425781 22.546020507812614 0, 85.06698608398449 22.542419433593693 0, 85.06483459472662 22.538530349731445 0, 85.0691909790039 22.532178878784237 0, 85.0764389038086 22.525283813476562 0, 85.07910919189453 22.518007278442496 0, 85.07804107666027 22.50874710083002 0, 85.07537841796886 22.501379013061523 0, 85.07402801513683 22.492235183715877 0, 85.07151031494146 22.486888885498047 0, 85.06682586669933 22.481884002685547 0, 85.05574798583996 22.48287963867199 0, 85.05107879638678 22.480854034423942 0, 85.04658508300793 22.480403900146484 0, 85.04167175292969 22.47854042053234 0, 85.03981018066406 22.480751037597713 0, 85.0376586914062 22.48038101196289 0, 85.03592681884777 22.473239898681754 0, 85.03245544433605 22.471670150756836 0, 85.02596282958996 22.4705753326416 0, 85.00487518310547 22.461822509765682 0, 85.00000000000006 22.46175193786621 0, 84.99850463867199 22.461729049682617 0, 84.9822006225586 22.454387664794865 0, 84.96465301513672 22.447181701660213 0, 84.96166992187506 22.445323944091854 0, 84.95899200439459 22.442367553710994 0, 84.95685577392584 22.442922592163143 0, 84.957763671875 22.448974609375 0, 84.95685577392584 22.456212997436523 0, 84.95169067382812 22.45451736450201 0, 84.9451904296875 22.450868606567496 0, 84.935806274414 22.443094253539982 0, 84.92976379394531 22.4400634765625 0, 84.92183685302746 22.43782043457037 0, 84.92258453369152 22.43202400207514 0, 84.92430877685558 22.429456710815373 0, 84.92084503173834 22.426845550537166 0, 84.91215515136713 22.42310714721674 0, 84.89823913574219 22.42146873474121 0, 84.88471221923828 22.421037673950195 0, 84.88645935058594 22.429685592651367 0, 84.88596343994152 22.432872772216797 0, 84.8839340209961 22.435619354248104 0, 84.88227081298828 22.445926666259822 0, 84.88099670410162 22.446641921997127 0, 84.87974548339844 22.444583892822322 0, 84.87571716308588 22.44162940979004 0, 84.86819458007818 22.437932968139705 0, 84.85983276367199 22.435392379760742 0, 84.85228729248047 22.43782043457037 0, 84.84586334228521 22.43826293945324 0, 84.8439559936524 22.437423706054744 0, 84.84024047851557 22.430946350097713 0, 84.83704376220703 22.429782867431584 0, 84.8361206054688 22.433317184448242 0, 84.83292388916021 22.432558059692496 0, 84.81719970703125 22.434986114501953 0, 84.81498718261724 22.43860054016119 0, 84.81496429443365 22.444614410400504 0, 84.8123168945313 22.45020675659174 0, 84.80577850341797 22.4470596313476 0, 84.79579162597668 22.4461669921875 0, 84.78258514404308 22.446868896484318 0, 84.75724029541027 22.44532585144043 0, 84.74842071533209 22.418109893798942 0, 84.73071289062511 22.419977188110465 0, 84.71592712402344 22.417232513427734 0, 84.69609832763672 22.41583633422863 0, 84.6861038208009 22.418224334716797 0, 84.67742156982422 22.418230056762752 0, 84.67395782470703 22.41960906982422 0, 84.6662216186524 22.417221069335994 0, 84.63672637939447 22.431898117065543 0, 84.63015747070318 22.43083572387701 0, 84.61830139160162 22.430818557739315 0, 84.59996795654297 22.428169250488224 0, 84.59862518310547 22.432060241699276 0, 84.59374237060553 22.428598403930607 0, 84.5768280029298 22.42621803283697 0, 84.54798889160168 22.420398712158317 0, 84.5453567504884 22.42378425598156 0, 84.5313339233399 22.423210144042912 0, 84.5257034301759 22.418081283569336 0, 84.5105590820313 22.41937446594244 0, 84.50650024414062 22.41849327087408 0, 84.48600006103527 22.40886878967291 0, 84.4814071655274 22.409156799316406 0, 84.47921752929688 22.404901504516715 0, 84.48069000244152 22.39673614501953 0, 84.48046112060558 22.393388748169002 0, 84.48494720458984 22.39044189453125 0, 84.48233032226568 22.38688468933117 0, 84.47754669189459 22.38590431213379 0, 84.4603881835938 22.378421783447322 0, 84.45260620117193 22.38227844238287 0, 84.4468383789063 22.37621879577648 0, 84.43168640136713 22.367845535278377 0, 84.43195343017584 22.365190505981502 0, 84.43621063232433 22.36322402954096 0, 84.43060302734375 22.355257034301815 0, 84.4308471679688 22.352039337158203 0, 84.42387390136713 22.353994369506836 0, 84.39926910400385 22.347057342529297 0, 84.39264678955078 22.349620819091854 0, 84.38236999511724 22.349109649658146 0, 84.37679290771484 22.35223579406744 0, 84.3722152709961 22.352750778198356 0, 84.36650848388672 22.351715087890625 0, 84.36389923095709 22.348220825195426 0, 84.35810089111328 22.34828376770031 0, 84.34976959228521 22.347225189208984 0, 84.34320831298828 22.345273971557674 0, 84.33881378173828 22.346076965332088 0, 84.3287963867188 22.342088699340877 0, 84.32357025146484 22.343650817871207 0, 84.31945037841803 22.342077255249137 0, 84.29406738281256 22.3404541015625 0, 84.2898559570313 22.345233917236385 0, 84.27809906005871 22.348201751708984 0, 84.27103424072277 22.350931167602653 0, 84.26573944091808 22.356775283813533 0, 84.25627899169922 22.373460769653434 0, 84.25142669677746 22.376747131347713 0, 84.24532318115246 22.377510070800838 0, 84.23101806640636 22.377141952514762 0, 84.19901275634766 22.374818801879826 0, 84.18834686279297 22.386659622192383 0, 84.18008422851574 22.391887664794922 0, 84.15741729736322 22.403850555419865 0, 84.14724731445324 22.418285369873104 0, 84.14082336425776 22.42354965209961 0, 84.1380462646485 22.44814682006836 0, 84.14017486572271 22.45187950134283 0, 84.14246368408209 22.4600067138673 0, 84.14239501953125 22.469898223876953 0, 84.13986968994135 22.47373580932623 0, 84.13564300537121 22.47279167175293 0, 84.13409423828136 22.47627449035639 0, 84.13054656982422 22.476371765136832 0, 84.12281036376959 22.474195480346737 0, 84.11109161376953 22.476615905761662 0, 84.10709381103516 22.480070114135742 0, 84.10845184326172 22.482076644897575 0, 84.10787200927734 22.484045028686523 0, 84.10486602783209 22.483093261718693 0, 84.09272766113293 22.487663269043082 0, 84.08421325683594 22.491561889648438 0, 84.07662963867193 22.496889114379826 0, 84.07206726074224 22.500810623169002 0, 84.07398986816412 22.50223731994629 0, 84.07168579101568 22.504920959472713 0, 84.06547546386713 22.507694244384822 0, 84.06259918212902 22.51280784606928 0, 84.05564117431646 22.515010833740348 0, 84.03807830810547 22.514713287353516 0, 84.02973937988287 22.518840789795036 0, 84.02416992187506 22.52368354797369 0, 84.02056121826178 22.524291992187443 0, 84.01466369628912 22.522899627685547 0, 84.00753021240234 22.523462295532227 0, 84.01021575927734 22.527322769165096 0, 84.00992584228527 22.53271102905279 0, 84.00659942626953 22.53656005859375 0, 84.00445556640625 22.542066574096737 0, 84.00716400146484 22.549156188964844 0, 84.00920867919916 22.55740737915039 0, 84.00897216796886 22.564455032348633 0, 84.0100936889649 22.572082519531307 0, 84.01608276367182 22.577518463134822 0, 84.0228042602539 22.58144378662115 0, 84.02505493164062 22.585298538208065 0, 84.026382446289 22.58973884582531 0, 84.03861236572266 22.593780517578125 0, 84.0469436645509 22.594692230224666 0, 84.05315399169928 22.596660614013786 0, 84.05789184570312 22.605113983154297 0, 84.06431579589855 22.609907150268555 0, 84.0853881835938 22.63902091979992 0, 84.09895324707037 22.6351318359375 0, 84.10263824462902 22.6355037689209 0, 84.11223602294922 22.639165878295955 0, 84.1203002929688 22.637763977050895 0, 84.13709259033209 22.638292312622127 0, 84.15490722656261 22.63695335388195 0, 84.16239929199219 22.64346694946289 0, 84.16979980468761 22.647846221923828 0, 84.18528747558594 22.652376174926758 0, 84.19656372070312 22.662782669067496 0, 84.20194244384771 22.666305541992244 0, 84.20655059814459 22.66771316528326 0, 84.21212768554699 22.667593002319393 0, 84.21460723876964 22.66554260253912 0, 84.21971893310553 22.667106628418082 0, 84.22553253173828 22.67144203186035 0, 84.23268127441412 22.679521560669002 0, 84.23716735839844 22.69109535217285 0, 84.23262023925781 22.700452804565543 0, 84.23437500000006 22.707712173461914 0, 84.23256683349604 22.725603103637695 0, 84.22966766357433 22.729797363281307 0, 84.23031616210938 22.737598419189567 0, 84.23467254638672 22.742580413818473 0, 84.24660491943365 22.750774383545036 0, 84.2565383911134 22.760498046875 0, 84.25865173339855 22.763137817382812 0, 84.25917053222662 22.7653865814209 0, 84.26502227783203 22.767353057861442 0, 84.2789535522461 22.768009185791016 0, 84.28369140625 22.763793945312557 0, 84.28636169433594 22.762548446655273 0, 84.29021453857422 22.76580429077154 0, 84.29260253906261 22.77333068847662 0, 84.29260253906261 22.77333831787115 0, 84.29263305664074 22.773324966430664 0, 84.31382751464844 22.76526260375988 0, 84.3195266723634 22.764646530151367 0, 84.32075500488287 22.76451301574707 0, 84.32546997070312 22.762905120849666 0, 84.33187866210949 22.75544548034668 0, 84.33794403076178 22.746704101562443 0, 84.34906005859386 22.746662139892578 0, 84.35337066650396 22.75068473815918 0, 84.34889984130871 22.75965690612793 0, 84.3511352539063 22.761249542236442 0, 84.36089324951183 22.75725555419922 0, 84.3666229248048 22.754909515380916 0, 84.37194061279308 22.75365257263195 0, 84.3748779296875 22.75835800170904 0, 84.37948608398438 22.762462615966797 0, 84.38771057128912 22.764711380004883 0, 84.3905868530274 22.76757621765148 0, 84.38887023925787 22.772691726684513 0, 84.39337158203125 22.77366828918457 0, 84.40044403076172 22.774200439453125 0, 84.4046401977539 22.76891899108898 0, 84.41022491455084 22.76387596130371 0, 84.4141845703125 22.763391494750977 0, 84.4163436889649 22.765630722045955 0, 84.41988372802734 22.779254913330078 0, 84.43196105957037 22.79262924194336 0, 84.43231201171875 22.79989624023449 0, 84.42758941650396 22.810073852539062 0, 84.4385223388673 22.807359695434684 0, 84.44373321533203 22.808589935302678 0, 84.44935607910162 22.813123703002987 0, 84.44920349121105 22.831920623779297 0, 84.44988250732428 22.83438873291027 0, 84.45549774169933 22.835882186889762 0, 84.46338653564453 22.834083557128906 0, 84.4734878540039 22.83314132690441 0, 84.50302124023432 22.821952819824276 0))",both
PASHCHIMI SINGHBHUM,1501619,749314,752305,209,"POLYGON Z ((85.34038543701172 22.88556480407715 0, 85.34167480468761 22.880128860473633 0, 85.35039520263678 22.880674362182674 0, 85.3545150756836 22.87907409667963 0, 85.35588073730474 22.871952056884766 0, 85.37094116210943 22.86268424987793 0, 85.3720474243164 22.8623371124267 0, 85.38359832763683 22.865673065185547 0, 85.38735198974615 22.863773345947266 0, 85.3896942138673 22.855276107788143 0, 85.38614654541016 22.846809387207145 0, 85.38811492919928 22.84194755554205 0, 85.39873504638672 22.844823837280387 0, 85.4059829711914 22.844442367553825 0, 85.4121322631836 22.83727455139166 0, 85.41588592529291 22.836362838745117 0, 85.41840362548828 22.832199096679688 0, 85.4302597045899 22.835882186889762 0, 85.4334487915039 22.8333415985108 0, 85.4360961914062 22.829708099365348 0, 85.43843078613281 22.822240829467773 0, 85.44156646728521 22.82017326354986 0, 85.44555664062506 22.819831848144588 0, 85.44703674316406 22.818794250488224 0, 85.45084381103516 22.81040954589838 0, 85.45189666748058 22.80606651306158 0, 85.45581817626959 22.802255630493107 0, 85.46195983886724 22.8008270263673 0, 85.46902465820318 22.800434112548828 0, 85.48038482666016 22.80515861511242 0, 85.48959350585943 22.803785324096737 0, 85.49818420410162 22.800687789916992 0, 85.50248718261719 22.80109405517578 0, 85.51041412353521 22.807949066162166 0, 85.51464843750011 22.809144973754883 0, 85.51466369628918 22.809139251709098 0, 85.52865600585938 22.80863189697277 0, 85.53507232666027 22.807567596435604 0, 85.53910827636719 22.820690155029354 0, 85.54847717285156 22.82357215881359 0, 85.55673980712896 22.821611404419002 0, 85.56200408935547 22.826118469238338 0, 85.56674957275385 22.832487106323185 0, 85.57367706298828 22.831773757934684 0, 85.58475494384771 22.829372406005803 0, 85.59345245361322 22.827646255493164 0, 85.60732269287121 22.825834274291992 0, 85.61252593994135 22.833490371704215 0, 85.61803436279308 22.844051361084098 0, 85.6197128295899 22.848230361938477 0, 85.62679290771496 22.848705291748047 0, 85.63292694091808 22.84829330444336 0, 85.63601684570312 22.848087310791016 0, 85.64258575439459 22.850515365600643 0, 85.64663696289074 22.849996566772575 0, 85.64851379394537 22.845043182373047 0, 85.65156555175787 22.842164993286133 0, 85.656021118164 22.841722488403263 0, 85.65868377685541 22.83885955810547 0, 85.66085052490234 22.833892822265625 0, 85.66368865966797 22.830562591552734 0, 85.669189453125 22.828975677490348 0, 85.67363739013678 22.826526641845646 0, 85.67510986328125 22.825714111328125 0, 85.68054962158209 22.818229675292912 0, 85.6919784545899 22.81807899475092 0, 85.6997909545899 22.808017730712834 0, 85.69705963134766 22.802406311035156 0, 85.69467163085943 22.788673400878906 0, 85.69734954833996 22.774536132812443 0, 85.69937896728516 22.76905441284191 0, 85.70307922363293 22.762741088867188 0, 85.70885467529291 22.758470535278377 0, 85.71649932861328 22.7561550140382 0, 85.71406555175781 22.745925903320256 0, 85.70906829833984 22.742980957031307 0, 85.7018051147461 22.743337631225643 0, 85.69448852539074 22.74583244323742 0, 85.6906127929688 22.74579238891613 0, 85.68524169921875 22.741018295288143 0, 85.68126678466803 22.729557037353572 0, 85.68299102783209 22.725805282592887 0, 85.6901092529298 22.717395782470817 0, 85.69064331054693 22.716764450073242 0, 85.69541168212896 22.71293640136713 0, 85.69819641113281 22.707727432251033 0, 85.69902038574224 22.70161437988287 0, 85.70206451416021 22.696340560913086 0, 85.70967864990234 22.693197250366325 0, 85.71509552001964 22.69216346740734 0, 85.71837615966808 22.687801361084098 0, 85.72464752197277 22.685907363891545 0, 85.72888183593744 22.687313079833984 0, 85.73213195800781 22.69115257263178 0, 85.73499298095703 22.690767288208065 0, 85.74176788330084 22.693460464477596 0, 85.74530029296875 22.699316024780387 0, 85.74985504150385 22.70135498046875 0, 85.75569152832037 22.700765609741268 0, 85.76325988769531 22.70112419128418 0, 85.77330780029308 22.699268341064567 0, 85.77534484863287 22.7095108032226 0, 85.78676605224615 22.70713996887207 0, 85.7942581176759 22.710355758667106 0, 85.79372406005854 22.713970184326286 0, 85.79032897949219 22.713731765747184 0, 85.7915725708009 22.717094421386832 0, 85.79477691650396 22.71770858764654 0, 85.80501556396484 22.71335411071783 0, 85.81132507324219 22.714496612548885 0, 85.815673828125 22.71617126464838 0, 85.81918334960943 22.71917152404791 0, 85.82293701171875 22.72086906433117 0, 85.82607269287115 22.72001266479498 0, 85.83241271972668 22.712858200073356 0, 85.83693695068365 22.70973396301264 0, 85.84249877929699 22.70970535278326 0, 85.84861755371105 22.72218704223627 0, 85.85137939453125 22.723922729492244 0, 85.85646820068371 22.720041275024357 0, 85.86028289794933 22.716484069824276 0, 85.86335754394531 22.711849212646598 0, 85.8632431030274 22.707061767578125 0, 85.860580444336 22.703109741210994 0, 85.85778808593761 22.70072937011713 0, 85.85918426513672 22.698556900024414 0, 85.86352539062511 22.69580841064453 0, 85.86565399169922 22.69231605529791 0, 85.86624145507812 22.687686920166016 0, 85.86574554443365 22.680978775024414 0, 85.86105346679682 22.667243957519588 0, 85.86074829101568 22.66255760192871 0, 85.86524200439464 22.654273986816463 0, 85.86595916748058 22.648164749145508 0, 85.86868286132807 22.642436981201286 0, 85.8726959228515 22.639057159423828 0, 85.87392425537115 22.635507583618278 0, 85.87090301513678 22.632469177246094 0, 85.87039184570324 22.631958007812557 0, 85.865478515625 22.621919631958065 0, 85.86897277832037 22.61800575256342 0, 85.8746948242188 22.61723136901861 0, 85.88143920898449 22.61936759948736 0, 85.88502502441412 22.61533927917486 0, 85.88634490966803 22.614118576049805 0, 85.89126586914068 22.610507965087947 0, 85.89788055419922 22.60757827758789 0, 85.90351867675787 22.607173919677678 0, 85.90804290771484 22.604049682617188 0, 85.90018463134766 22.590440750122127 0, 85.9003677368164 22.585641860961914 0, 85.89836120605474 22.580835342407227 0, 85.89429473876953 22.578689575195312 0, 85.88909149169916 22.578010559082088 0, 85.88830566406261 22.577909469604492 0, 85.87458801269543 22.570701599121094 0, 85.8720092773438 22.566286087036246 0, 85.87294006347656 22.562747955322266 0, 85.87625122070318 22.559118270874137 0, 85.88169860839844 22.556694030761832 0, 85.8875198364259 22.558128356933594 0, 85.89247894287121 22.555999755859375 0, 85.901596069336 22.549194335937557 0, 85.90516662597656 22.544723510742188 0, 85.89702606201178 22.527072906494084 0, 85.90784454345703 22.520568847656307 0, 85.90959167480474 22.513130187988338 0, 85.92050170898443 22.506622314453125 0, 85.92510986328136 22.50091934204113 0, 85.92557525634766 22.50034141540533 0, 85.93392944335938 22.496421813964957 0, 85.94821929931635 22.490966796875 0, 85.95088958740229 22.48995018005371 0, 85.96433258056646 22.482603073120174 0, 85.96435546875006 22.482585906982536 0, 85.96172332763683 22.480167388916016 0, 85.96292877197266 22.474378585815487 0, 85.96184539794928 22.46990394592291 0, 85.9570922851563 22.459989547729492 0, 85.96498870849621 22.456743240356502 0, 85.96669006347668 22.44916343688965 0, 85.97054290771479 22.445268630981502 0, 85.98568725585943 22.433065414428825 0, 85.99650573730469 22.42622947692871 0, 86.00039672851568 22.425741195678768 0, 86.00354766845703 22.426742553710994 0, 86.00639343261713 22.42915534973156 0, 86.00953674316412 22.429450988769645 0, 86.01226806640636 22.428421020507812 0, 86.01326751708979 22.425758361816406 0, 86.01313781738281 22.423000335693416 0, 86.01557922363281 22.418846130371094 0, 86.01716613769537 22.40802001953125 0, 86.01580047607422 22.40312767028803 0, 86.01831054687506 22.401191711425838 0, 86.0192489624024 22.397491455078125 0, 86.02153778076178 22.39739418029791 0, 86.02259063720714 22.394815444946403 0, 86.02108001708979 22.39028739929205 0, 86.0240325927735 22.38836669921875 0, 86.02501678466803 22.385934829711914 0, 86.02312469482433 22.382337570190373 0, 86.02474975585938 22.379228591918945 0, 86.0224075317384 22.378942489624023 0, 86.0219345092774 22.37572097778326 0, 86.01947784423834 22.3771591186524 0, 86.01879119873041 22.37019538879406 0, 86.02037048339844 22.36643409729004 0, 86.00965881347656 22.352977752685547 0, 85.99641418457037 22.342393875122013 0, 85.99935150146484 22.33736228942871 0, 86.00195312500011 22.33533096313488 0, 86.00827026367199 22.339889526367188 0, 86.01750183105469 22.338750839233455 0, 86.02393341064464 22.33366203308117 0, 86.022689819336 22.331392288208008 0, 86.01676940917974 22.32822418212885 0, 86.00942993164074 22.320186614990234 0, 86.01195526123047 22.317522048950252 0, 86.01191711425793 22.31424331665039 0, 86.01468658447271 22.31486129760748 0, 86.01490020751959 22.313684463501033 0, 86.02127075195307 22.308847427368164 0, 86.02391052246105 22.30983734130865 0, 86.02821350097662 22.308479309082088 0, 86.03164672851568 22.31198883056652 0, 86.03578186035156 22.309539794921818 0, 86.0375595092774 22.312246322631893 0, 86.04280090332043 22.312952041626033 0, 86.04572296142578 22.312541961669922 0, 86.04676818847662 22.31049919128418 0, 86.04342651367188 22.307870864868107 0, 86.0337982177735 22.307298660278263 0, 86.03286743164074 22.305074691772575 0, 86.03079986572277 22.30381393432623 0, 86.02688598632818 22.30198478698736 0, 86.02323913574219 22.302137374877987 0, 86.01956176757807 22.300844192504883 0, 86.01199340820312 22.296991348266545 0, 86.00374603271484 22.28870201110834 0, 86.00573730468756 22.285793304443303 0, 86.00424194335949 22.283668518066463 0, 86.0010452270509 22.27968215942377 0, 85.99655151367193 22.277627944946346 0, 85.98871612548828 22.271553039550895 0, 85.98896026611334 22.261821746826172 0, 85.985336303711 22.256427764892578 0, 85.97332000732428 22.247783660888786 0, 85.97489166259777 22.242767333984318 0, 85.98131561279303 22.239948272705135 0, 85.98864746093761 22.22826004028326 0, 85.99634552001953 22.219924926757812 0, 86.02086639404308 22.203233718872127 0, 86.02902984619146 22.19371604919428 0, 86.03018951416027 22.189731597900447 0, 86.01827239990234 22.177158355712947 0, 86.0160522460938 22.172389984130916 0, 86.01659393310553 22.168148040771484 0, 86.01489257812506 22.162208557128963 0, 86.00733184814464 22.15560340881359 0, 86.00273895263683 22.149490356445426 0, 86.00318908691406 22.14697456359869 0, 86.0025787353515 22.14168357849121 0, 85.99812316894537 22.13636970520031 0, 85.99858093261713 22.12817001342779 0, 85.99957275390625 22.12525367736822 0, 86.00607299804688 22.117639541626033 0, 86.00394439697266 22.11359596252447 0, 85.99610137939447 22.104881286621037 0, 85.99269104003906 22.09810256958002 0, 85.98249816894543 22.088020324707088 0, 85.98080444335949 22.084703445434513 0, 85.98088836669922 22.081413269042912 0, 85.97879791259766 22.076467514038086 0, 85.97472381591808 22.071502685546818 0, 85.97088623046886 22.064474105835018 0, 85.96681976318365 22.059129714965934 0, 85.96150207519537 22.047224044799748 0, 85.9570922851563 22.040830612182674 0, 85.95505523681652 22.03637123107916 0, 85.9482421875 22.028013229370117 0, 85.9461135864259 22.023880004882812 0, 85.94209289550793 22.021368026733455 0, 85.93663024902344 22.022192001342887 0, 85.93231964111334 22.024108886718807 0, 85.92842102050781 22.022102355956974 0, 85.92693328857428 22.018833160400447 0, 85.92308807373047 22.014551162719727 0, 85.91579437255854 22.00956535339361 0, 85.91661071777344 22.001432418823356 0, 85.91280364990234 21.994918823242244 0, 85.9108123779298 21.98611259460455 0, 85.91320037841803 21.98240280151373 0, 85.91276550292969 21.980360031127987 0, 85.90802001953125 21.97748374938965 0, 85.9095458984375 21.972911834716854 0, 85.90898132324219 21.971462249755803 0, 85.90641021728527 21.971420288085938 0, 85.89773559570312 21.98308753967285 0, 85.89470672607428 21.983324050903377 0, 85.88969421386719 21.980220794677678 0, 85.88532257080078 21.97962570190441 0, 85.87490081787115 21.979551315307617 0, 85.85059356689453 21.98185729980463 0, 85.8440399169923 21.981260299682617 0, 85.83223724365246 21.977712631225643 0, 85.82589721679693 21.97490882873535 0, 85.82197570800781 21.974794387817496 0, 85.81920623779303 21.976070404052734 0, 85.81970977783203 21.980110168457145 0, 85.8190383911134 21.984888076782283 0, 85.81627655029297 21.985712051391545 0, 85.8088150024414 21.98497200012207 0, 85.80462646484375 21.986412048339957 0, 85.78794097900396 21.983360290527457 0, 85.78585815429699 21.984140396118278 0, 85.78417968750011 21.985784530639762 0, 85.77508544921875 21.988433837890682 0, 85.76443481445318 21.99443435668951 0, 85.76421356201172 22.00164222717291 0, 85.75980377197266 22.013069152832088 0, 85.7623977661134 22.01947021484375 0, 85.76554107666016 22.02261352539074 0, 85.77584838867188 22.02936363220215 0, 85.77928924560547 22.03293228149414 0, 85.78262329101574 22.040904998779297 0, 85.77698516845703 22.047943115234432 0, 85.77491760253912 22.05177307128912 0, 85.77402496337902 22.055902481079045 0, 85.7887954711914 22.076498031616268 0, 85.79160308837902 22.08176040649414 0, 85.80042266845703 22.079090118408203 0, 85.80639648437506 22.076360702514762 0, 85.81802368164068 22.074678421020565 0, 85.83438110351562 22.08157348632824 0, 85.83172607421875 22.087249755859432 0, 85.82856750488287 22.0917129516601 0, 85.82260894775396 22.094203948974666 0, 85.81907653808605 22.09738540649414 0, 85.81237030029308 22.096405029296932 0, 85.81886291503918 22.10358810424816 0, 85.81838989257812 22.106658935546875 0, 85.8057327270509 22.115356445312443 0, 85.80084228515625 22.110837936401424 0, 85.79766082763678 22.109905242920036 0, 85.79459381103521 22.104928970336857 0, 85.78794097900396 22.10352897644043 0, 85.78274536132818 22.097969055175895 0, 85.77706909179693 22.094785690307617 0, 85.76870727539074 22.092765808105526 0, 85.76152038574219 22.0895290374757 0, 85.75585174560553 22.083803176879883 0, 85.75414276123053 22.078958511352653 0, 85.74977111816412 22.074451446533146 0, 85.73754119873053 22.069101333618164 0, 85.72608947753912 22.062707901001033 0, 85.72129821777344 22.062309265136832 0, 85.71651458740234 22.060981750488395 0, 85.71154022216797 22.060865402221737 0, 85.70839691162115 22.058898925781193 0, 85.69976043701172 22.061403274536246 0, 85.69164276123058 22.060634613037166 0, 85.68526458740234 22.05335807800293 0, 85.67572021484375 22.05603218078619 0, 85.67613983154303 22.06426239013672 0, 85.67136383056646 22.06557655334484 0, 85.66852569580084 22.071104049682617 0, 85.66129302978521 22.078784942627067 0, 85.65912628173828 22.082319259643498 0, 85.65413665771484 22.085802078247184 0, 85.65185546875 22.091297149658203 0, 85.64842987060547 22.09476852416998 0, 85.64384460449219 22.094715118408203 0, 85.64019775390625 22.090263366699276 0, 85.63506317138672 22.08603096008295 0, 85.63005828857433 22.084125518798942 0, 85.6234130859375 22.082332611083984 0, 85.6149291992188 22.08129119873047 0, 85.61243438720709 22.083435058593807 0, 85.6111526489259 22.086263656616268 0, 85.60743713378906 22.083719253540153 0, 85.60560607910168 22.080825805664176 0, 85.60048675537121 22.07920646667486 0, 85.59494018554699 22.07892417907715 0, 85.59062194824219 22.0812931060791 0, 85.58610534667974 22.08546066284191 0, 85.5749740600586 22.090503692626953 0, 85.57009887695318 22.091484069824332 0, 85.56411743164062 22.08934211730957 0, 85.5582275390625 22.095245361328182 0, 85.55249786376953 22.09298324584961 0, 85.54342651367199 22.091016769409237 0, 85.5412368774414 22.094722747802734 0, 85.53995513916021 22.098821640014705 0, 85.53739929199219 22.101203918457145 0, 85.53265380859375 22.103164672851506 0, 85.52808380126953 22.107442855835075 0, 85.5187606811524 22.112586975097713 0, 85.50962066650396 22.11582756042486 0, 85.48976135253906 22.120836257934627 0, 85.48336029052746 22.12610626220703 0, 85.47568511962896 22.128463745117244 0, 85.46914672851562 22.135509490966797 0, 85.46097564697271 22.140071868896428 0, 85.43975830078125 22.148439407348633 0, 85.42181396484375 22.157602310180664 0, 85.41431427001964 22.16031265258789 0, 85.40638732910156 22.160758972167912 0, 85.39846801757824 22.162824630737305 0, 85.39437866210938 22.1593532562257 0, 85.38939666748047 22.156564712524528 0, 85.3833618164063 22.155916213989258 0, 85.37622833251953 22.15665626525879 0, 85.37342071533209 22.159427642822322 0, 85.36726379394531 22.158781051635856 0, 85.36648559570307 22.15426826477062 0, 85.36698150634771 22.1508026123048 0, 85.36212921142578 22.142181396484432 0, 85.36270141601562 22.137041091919002 0, 85.36577606201172 22.12901878356945 0, 85.36542510986334 22.125719070434513 0, 85.36219024658209 22.12386703491211 0, 85.3576278686524 22.12484359741211 0, 85.34944152832037 22.131238937377987 0, 85.34256744384771 22.128969192504883 0, 85.3270874023438 22.129228591919002 0, 85.31945037841803 22.12008666992199 0, 85.3137893676759 22.117643356323242 0, 85.304183959961 22.111314773559627 0, 85.29153442382812 22.097448348999023 0, 85.28501129150402 22.0919189453125 0, 85.27827453613287 22.08438491821289 0, 85.27408599853521 22.073261260986442 0, 85.2695770263673 22.06456565856945 0, 85.26411437988281 22.05717086791998 0, 85.26023101806652 22.046794891357365 0, 85.25066375732433 22.029773712158317 0, 85.24519348144531 22.016899108886832 0, 85.23509216308594 22.004667282104606 0, 85.22628021240246 22.007831573486442 0, 85.2225112915039 22.011049270629996 0, 85.21905517578125 22.015073776245174 0, 85.21798706054693 22.020639419555664 0, 85.21804809570324 22.031503677368164 0, 85.21878051757818 22.041595458984375 0, 85.21491241455078 22.047489166259822 0, 85.19649505615246 22.055431365966797 0, 85.1912002563476 22.057006835937443 0, 85.18765258789068 22.0591983795166 0, 85.18331909179699 22.069040298462028 0, 85.18095397949219 22.070970535278263 0, 85.17665863037121 22.072431564331055 0, 85.17380523681652 22.070337295532283 0, 85.16857910156256 22.069471359252987 0, 85.1740188598634 22.05736732482916 0, 85.17501068115234 22.052467346191406 0, 85.17140197753906 22.052957534790096 0, 85.16796112060547 22.057264328002987 0, 85.1631851196289 22.066156387329215 0, 85.16201782226557 22.07121086120617 0, 85.1597671508789 22.074682235717717 0, 85.15311431884766 22.07685661315918 0, 85.14506530761719 22.077751159668082 0, 85.13928222656261 22.075347900390625 0, 85.129638671875 22.073328018188477 0, 85.12311553955078 22.070682525634766 0, 85.11753845214855 22.075273513794002 0, 85.114517211914 22.080049514770565 0, 85.11320495605469 22.08420181274414 0, 85.1087265014649 22.08694648742687 0, 85.10395812988287 22.08870124816889 0, 85.10327148437494 22.100261688232422 0, 85.0997085571289 22.103586196899357 0, 85.08836364746105 22.104570388793945 0, 85.0805053710938 22.10708999633789 0, 85.07373809814453 22.111232757568473 0, 85.0481948852539 22.114780426025447 0, 85.03944396972662 22.112211227417106 0, 85.03549194335943 22.1065731048584 0, 85.0314331054688 22.10522651672369 0, 85.02427673339855 22.107452392578182 0, 85.01838684082026 22.097801208496207 0, 85.01334381103521 22.094741821289176 0, 85.01152801513666 22.08723831176752 0, 85.00666809082037 22.084049224853516 0, 85.00000000000006 22.08196449279791 0, 84.99794006347668 22.08132171630865 0, 84.99177551269537 22.080846786499023 0, 84.98538208007824 22.08651351928711 0, 84.98416137695318 22.088766098022575 0, 84.98484802246094 22.095335006713867 0, 84.98780822753912 22.09556198120123 0, 84.99019622802734 22.09664916992199 0, 84.99797821044916 22.102020263671818 0, 85.00000000000006 22.10283851623535 0, 85.02379608154297 22.11246109008789 0, 85.02806091308605 22.116048812866325 0, 85.02861022949224 22.121995925903377 0, 85.0316848754884 22.12661170959484 0, 85.03546905517584 22.141387939453182 0, 85.03462219238281 22.14647674560547 0, 85.03050994873053 22.152454376220646 0, 85.0297241210938 22.157993316650334 0, 85.0323486328125 22.16134834289562 0, 85.03755187988287 22.16483497619629 0, 85.0457611083985 22.174650192260742 0, 85.05209350585949 22.178287506103572 0, 85.05390167236328 22.183279037475586 0, 85.0512466430664 22.189741134643555 0, 85.06310272216803 22.20987892150879 0, 85.0668334960937 22.22006988525385 0, 85.07376861572266 22.234550476074332 0, 85.0724105834961 22.24731254577631 0, 85.0763626098634 22.249591827392578 0, 85.07860565185558 22.254804611206055 0, 85.07421112060553 22.26413726806635 0, 85.07373046875 22.271413803100643 0, 85.07480621337902 22.275985717773438 0, 85.08663177490246 22.281536102295036 0, 85.1028518676759 22.29173851013178 0, 85.10956573486322 22.294952392578182 0, 85.11263275146484 22.29328727722168 0, 85.11872863769531 22.29430389404297 0, 85.1191177368164 22.304185867309684 0, 85.11644744873047 22.30885314941412 0, 85.11830139160168 22.31799697875988 0, 85.1120071411134 22.319000244140682 0, 85.10552215576183 22.31810379028326 0, 85.09942626953136 22.31616401672369 0, 85.09225463867188 22.317859649658203 0, 85.09020996093756 22.320735931396484 0, 85.09475708007818 22.328617095947322 0, 85.0972518920899 22.344818115234318 0, 85.08647918701166 22.345050811767692 0, 85.0842056274414 22.348096847534237 0, 85.07836151123053 22.35228729248047 0, 85.07979583740246 22.359458923339957 0, 85.07934570312506 22.364660263061523 0, 85.08218383789068 22.372825622558707 0, 85.08739471435558 22.38210296630865 0, 85.08499145507812 22.399085998535213 0, 85.08152008056635 22.406642913818416 0, 85.0815658569336 22.411909103393498 0, 85.07891845703125 22.41704750061041 0, 85.07241821289062 22.421644210815373 0, 85.06800079345703 22.426780700683707 0, 85.0672378540039 22.439622879028434 0, 85.06248474121094 22.443267822265625 0, 85.06137847900396 22.448232650756893 0, 85.06481933593756 22.453025817871094 0, 85.07542419433588 22.45941352844244 0, 85.07526397705078 22.464666366577205 0, 85.07795715332031 22.470172882080192 0, 85.0775375366211 22.47636222839367 0, 85.06682586669933 22.481884002685547 0, 85.07151031494146 22.486888885498047 0, 85.07402801513683 22.492235183715877 0, 85.07537841796886 22.501379013061523 0, 85.07804107666027 22.50874710083002 0, 85.07910919189453 22.518007278442496 0, 85.0764389038086 22.525283813476562 0, 85.0691909790039 22.532178878784237 0, 85.06483459472662 22.538530349731445 0, 85.06698608398449 22.542419433593693 0, 85.07051086425781 22.546020507812614 0, 85.07100677490246 22.549556732177848 0, 85.0679397583009 22.560892105102596 0, 85.06990814208984 22.565187454223633 0, 85.07395935058594 22.56729698181158 0, 85.07806396484386 22.571203231811523 0, 85.08737945556652 22.57257843017578 0, 85.090103149414 22.575082778930607 0, 85.08992767333984 22.58202171325695 0, 85.09267425537115 22.58701324462902 0, 85.09505462646496 22.596275329589844 0, 85.0886001586914 22.605955123901367 0, 85.08569335937511 22.60877799987793 0, 85.07534027099615 22.61473464965826 0, 85.07512664794928 22.6172714233399 0, 85.07846832275385 22.620986938476676 0, 85.08180236816412 22.626390457153263 0, 85.08633422851562 22.62786483764654 0, 85.08992004394526 22.633207321166992 0, 85.0916519165039 22.640214920044002 0, 85.09434509277344 22.64520835876465 0, 85.09479522705084 22.650989532470817 0, 85.11377716064453 22.65845108032238 0, 85.11508941650385 22.668292999267635 0, 85.11746978759771 22.673974990844783 0, 85.11804962158209 22.684452056884766 0, 85.12194824218761 22.688405990600643 0, 85.1204071044923 22.694818496704215 0, 85.11975860595709 22.702512741088924 0, 85.12084197998047 22.70916748046875 0, 85.1253051757813 22.7138290405274 0, 85.12989807128912 22.717205047607536 0, 85.13018798828125 22.720735549926815 0, 85.12797546386724 22.722576141357365 0, 85.12924194335938 22.728088378906307 0, 85.12763977050793 22.731491088867188 0, 85.12761688232428 22.736465454101562 0, 85.13050079345714 22.738044738769588 0, 85.14069366455078 22.738559722900504 0, 85.1438674926759 22.74211502075201 0, 85.14501953125011 22.74548149108898 0, 85.13831329345714 22.752212524414176 0, 85.13736724853527 22.75943374633789 0, 85.1386337280274 22.765523910522404 0, 85.13871002197277 22.778434753418026 0, 85.1466064453125 22.806793212890625 0, 85.15805053710938 22.82225799560547 0, 85.15435028076183 22.824380874633732 0, 85.156494140625 22.82972335815441 0, 85.16010284423822 22.832925796508903 0, 85.1665496826173 22.83522224426281 0, 85.17153167724621 22.833683013916072 0, 85.17645263671886 22.83011817932129 0, 85.18088531494152 22.825456619262752 0, 85.18968200683594 22.825906753539982 0, 85.19226074218756 22.82441711425787 0, 85.19208526611334 22.82099533081049 0, 85.18786621093756 22.814893722534293 0, 85.18904113769543 22.812585830688477 0, 85.19388580322266 22.812953948974723 0, 85.19577789306635 22.81829071044922 0, 85.19842529296886 22.8149471282959 0, 85.20418548583984 22.819145202636832 0, 85.21388244628918 22.824697494506836 0, 85.22084808349615 22.83451652526861 0, 85.22644042968761 22.83831024169922 0, 85.2326431274414 22.837646484375114 0, 85.24211883544916 22.835020065307617 0, 85.24745941162104 22.835220336914062 0, 85.25389099121105 22.844459533691463 0, 85.25682830810547 22.8471298217774 0, 85.25990295410156 22.84529685974121 0, 85.26395416259771 22.846351623535213 0, 85.26554107666027 22.850296020507812 0, 85.2647323608399 22.85504722595215 0, 85.26670074462902 22.856792449951286 0, 85.26663208007818 22.860319137573185 0, 85.27160644531256 22.862598419189453 0, 85.27400207519531 22.8610458374024 0, 85.27565765380871 22.864704132080078 0, 85.27957153320312 22.8699893951416 0, 85.280746459961 22.870864868164006 0, 85.28418731689459 22.86960411071783 0, 85.28565216064453 22.872730255126953 0, 85.2874374389649 22.870885848999023 0, 85.28896331787115 22.87356376647955 0, 85.29682922363293 22.87567520141613 0, 85.3035888671875 22.874893188476562 0, 85.30647277832037 22.877685546875114 0, 85.30780792236334 22.88335609436035 0, 85.31063842773438 22.884880065918026 0, 85.31278991699224 22.882972717285213 0, 85.31611633300793 22.883049011230582 0, 85.31925201416021 22.88132095336914 0, 85.33159637451172 22.88281059265148 0, 85.34038543701172 22.88556480407715 0))",both
SARAIKELLA KHARSAWAN,1063458,543232,520226,390,"POLYGON Z ((85.89299774169928 23.154642105102596 0, 85.90419006347656 23.15099525451666 0, 85.91055297851568 23.144981384277344 0, 85.91540527343761 23.136503219604435 0, 85.9187850952149 23.132463455200195 0, 85.92160797119146 23.134077072143555 0, 85.92334747314459 23.129884719848746 0, 85.92526245117193 23.12887191772461 0, 85.92580413818365 23.13233757019043 0, 85.92960357666021 23.13358497619629 0, 85.9400634765625 23.132614135742188 0, 85.94758605957037 23.132419586181754 0, 85.95050811767572 23.133825302124137 0, 85.9516830444336 23.13689994812006 0, 85.95532989501953 23.14109802246105 0, 85.96005249023432 23.142414093017578 0, 85.96309661865229 23.14271163940441 0, 85.97422790527344 23.142974853515682 0, 85.98567199707031 23.148845672607536 0, 85.99379730224621 23.149223327636776 0, 85.99929809570324 23.147375106811467 0, 86.0063095092774 23.149126052856502 0, 86.00981903076183 23.147853851318473 0, 86.01343536376964 23.14794349670416 0, 86.01759338378918 23.144607543945312 0, 86.0217056274414 23.143459320068416 0, 86.02848052978527 23.146163940429688 0, 86.03205871582037 23.1486759185791 0, 86.03597259521484 23.148056030273438 0, 86.0406112670899 23.14658927917492 0, 86.04568481445307 23.13895606994629 0, 86.05207824707037 23.13217353820812 0, 86.05263519287115 23.12785530090332 0, 86.05020904541027 23.12370109558117 0, 86.0479125976563 23.114881515502987 0, 86.0516586303711 23.111705780029297 0, 86.06293487548834 23.108594894409237 0, 86.07366180419928 23.10447692871105 0, 86.08459472656244 23.107368469238224 0, 86.0868606567384 23.103984832763786 0, 86.08721160888683 23.101654052734318 0, 86.09541320800793 23.093851089477653 0, 86.10073089599615 23.094749450683707 0, 86.10839080810558 23.091989517211914 0, 86.11001586914062 23.09337425231945 0, 86.11779022216791 23.09504318237316 0, 86.11930847167963 23.096717834472656 0, 86.1309585571289 23.092172622680607 0, 86.13223266601574 23.088830947876033 0, 86.14015197753906 23.086212158203068 0, 86.14163208007807 23.083591461181754 0, 86.13722229003918 23.073024749755916 0, 86.13815307617199 23.066072463989258 0, 86.14170074462896 23.062477111816463 0, 86.1496047973634 23.058870315551815 0, 86.15189361572277 23.055833816528377 0, 86.15357208251959 23.044078826904354 0, 86.15721130371105 23.040412902832145 0, 86.16371154785168 23.042243957519588 0, 86.16584777832026 23.03700828552246 0, 86.17024993896484 23.030164718627987 0, 86.176025390625 23.026266098022404 0, 86.1791458129884 23.01623153686529 0, 86.181884765625 23.014949798584098 0, 86.18470764160168 23.01619911193859 0, 86.2043838500976 23.018381118774414 0, 86.2078628540039 23.016452789306754 0, 86.20374298095709 23.01300048828125 0, 86.20731353759771 23.001138687133903 0, 86.20990753173822 22.99734687805187 0, 86.21596527099621 22.995134353637695 0, 86.22044372558594 22.99489784240717 0, 86.23053741455078 22.99615669250494 0, 86.23442077636724 22.995431900024528 0, 86.23793029785168 22.99665451049799 0, 86.23793792724621 22.99663734436035 0, 86.24020385742199 22.992027282714844 0, 86.24392700195312 22.98874092102062 0, 86.24278259277344 22.981414794921932 0, 86.23943328857433 22.97583770751953 0, 86.23602294921886 22.973304748535156 0, 86.23002624511724 22.972721099853572 0, 86.22531890869152 22.974205017089957 0, 86.21860504150396 22.973373413085994 0, 86.21530151367188 22.968807220458928 0, 86.20362854003906 22.970298767089844 0, 86.19533538818365 22.969621658325252 0, 86.18645477294916 22.94823265075695 0, 86.19152832031256 22.945999145507926 0, 86.18950653076166 22.934928894043082 0, 86.19226837158209 22.93020820617687 0, 86.18972778320312 22.92699432373047 0, 86.1880493164063 22.92309761047369 0, 86.19051361083984 22.90991020202631 0, 86.18984985351574 22.904407501220703 0, 86.19160461425776 22.89945220947277 0, 86.19480895996105 22.89775466918951 0, 86.19817352294928 22.8994598388673 0, 86.20840454101562 22.892959594726676 0, 86.21138763427746 22.892837524414062 0, 86.21765899658209 22.89092254638672 0, 86.2156219482423 22.886617660522575 0, 86.20948028564464 22.873653411865234 0, 86.20652770996094 22.872299194335994 0, 86.20063781738287 22.86756324768072 0, 86.19800567626959 22.86241722106928 0, 86.1984100341798 22.8480224609375 0, 86.1976776123048 22.840864181518498 0, 86.19892883300787 22.837863922119197 0, 86.19430541992188 22.828466415405217 0, 86.19445037841808 22.818967819213867 0, 86.1836166381836 22.823280334472713 0, 86.1800384521485 22.82545280456543 0, 86.17367553710932 22.833822250366154 0, 86.15917968749994 22.838466644287166 0, 86.1568222045899 22.83487510681158 0, 86.15681457519537 22.824092864990234 0, 86.15587615966808 22.821180343628043 0, 86.14650726318365 22.814371109008846 0, 86.14364624023443 22.80628585815441 0, 86.14503479003918 22.799961090088004 0, 86.14654541015636 22.79815101623541 0, 86.15735626220709 22.801952362060547 0, 86.16005706787115 22.80018234252941 0, 86.16390991210949 22.795417785644588 0, 86.16733551025402 22.79426574707037 0, 86.17041778564464 22.794324874877873 0, 86.17146301269537 22.791240692138615 0, 86.17166137695318 22.78904724121088 0, 86.17198181152344 22.78541374206543 0, 86.16928100585932 22.764049530029354 0, 86.16392517089855 22.762054443359432 0, 86.15969085693371 22.75660514831543 0, 86.15714263916016 22.748874664306754 0, 86.1585311889649 22.746791839599553 0, 86.159423828125 22.736248016357536 0, 86.16291046142584 22.734355926513786 0, 86.16389465332043 22.725652694702262 0, 86.16055297851562 22.717954635620174 0, 86.1619720458985 22.699470520019588 0, 86.16240692138683 22.677328109741268 0, 86.16718292236322 22.67114448547369 0, 86.15798187255871 22.654314041137752 0, 86.15550994873058 22.651067733764762 0, 86.15486145019537 22.637269973754826 0, 86.14756774902344 22.632036209106502 0, 86.14298248291016 22.625402450561523 0, 86.1364212036134 22.618755340576286 0, 86.11727905273438 22.606441497802734 0, 86.11250305175781 22.597604751586914 0, 86.10628509521496 22.59204864501953 0, 86.10381317138683 22.588909149169922 0, 86.10037994384777 22.584545135498047 0, 86.07583618164062 22.568943023681697 0, 86.07286834716803 22.566123962402344 0, 86.07043457031261 22.56381416320812 0, 86.06534576416016 22.552410125732536 0, 86.06532287597668 22.552425384521428 0, 86.06164550781256 22.557321548462028 0, 86.05690765380871 22.558553695678825 0, 86.05017852783209 22.56178283691412 0, 86.04202270507824 22.5674724578858 0, 86.02188873291016 22.54754066467291 0, 86.03179931640625 22.53825187683111 0, 86.02558135986334 22.52449989318859 0, 86.01900482177734 22.528413772583008 0, 86.01223754882818 22.522485733032227 0, 86.00534057617193 22.51881027221691 0, 86.00342559814459 22.518907546997127 0, 85.99947357177746 22.512912750244254 0, 85.99653625488281 22.512861251831055 0, 85.9877090454101 22.51456832885748 0, 85.98428344726562 22.513681411743164 0, 85.97284698486328 22.50374031066889 0, 85.96995544433605 22.497774124145565 0, 85.96920776367182 22.494127273559627 0, 85.97059631347656 22.489984512329215 0, 85.97032928466808 22.48613929748541 0, 85.96437835693371 22.482603073120174 0, 85.96435546875006 22.482585906982536 0, 85.96433258056646 22.482603073120174 0, 85.95088958740229 22.48995018005371 0, 85.94821929931635 22.490966796875 0, 85.93392944335938 22.496421813964957 0, 85.92557525634766 22.50034141540533 0, 85.92510986328136 22.50091934204113 0, 85.92050170898443 22.506622314453125 0, 85.90959167480474 22.513130187988338 0, 85.90784454345703 22.520568847656307 0, 85.89702606201178 22.527072906494084 0, 85.90516662597656 22.544723510742188 0, 85.901596069336 22.549194335937557 0, 85.89247894287121 22.555999755859375 0, 85.8875198364259 22.558128356933594 0, 85.88169860839844 22.556694030761832 0, 85.87625122070318 22.559118270874137 0, 85.87294006347656 22.562747955322266 0, 85.8720092773438 22.566286087036246 0, 85.87458801269543 22.570701599121094 0, 85.88830566406261 22.577909469604492 0, 85.88909149169916 22.578010559082088 0, 85.89429473876953 22.578689575195312 0, 85.89836120605474 22.580835342407227 0, 85.9003677368164 22.585641860961914 0, 85.90018463134766 22.590440750122127 0, 85.90804290771484 22.604049682617188 0, 85.90351867675787 22.607173919677678 0, 85.89788055419922 22.60757827758789 0, 85.89126586914068 22.610507965087947 0, 85.88634490966803 22.614118576049805 0, 85.88502502441412 22.61533927917486 0, 85.88143920898449 22.61936759948736 0, 85.8746948242188 22.61723136901861 0, 85.86897277832037 22.61800575256342 0, 85.865478515625 22.621919631958065 0, 85.87039184570324 22.631958007812557 0, 85.87090301513678 22.632469177246094 0, 85.87392425537115 22.635507583618278 0, 85.8726959228515 22.639057159423828 0, 85.86868286132807 22.642436981201286 0, 85.86595916748058 22.648164749145508 0, 85.86524200439464 22.654273986816463 0, 85.86074829101568 22.66255760192871 0, 85.86105346679682 22.667243957519588 0, 85.86574554443365 22.680978775024414 0, 85.86624145507812 22.687686920166016 0, 85.86565399169922 22.69231605529791 0, 85.86352539062511 22.69580841064453 0, 85.85918426513672 22.698556900024414 0, 85.85778808593761 22.70072937011713 0, 85.860580444336 22.703109741210994 0, 85.8632431030274 22.707061767578125 0, 85.86335754394531 22.711849212646598 0, 85.86028289794933 22.716484069824276 0, 85.85646820068371 22.720041275024357 0, 85.85137939453125 22.723922729492244 0, 85.84861755371105 22.72218704223627 0, 85.84249877929699 22.70970535278326 0, 85.83693695068365 22.70973396301264 0, 85.83241271972668 22.712858200073356 0, 85.82607269287115 22.72001266479498 0, 85.82293701171875 22.72086906433117 0, 85.81918334960943 22.71917152404791 0, 85.815673828125 22.71617126464838 0, 85.81132507324219 22.714496612548885 0, 85.80501556396484 22.71335411071783 0, 85.79477691650396 22.71770858764654 0, 85.7915725708009 22.717094421386832 0, 85.79032897949219 22.713731765747184 0, 85.79372406005854 22.713970184326286 0, 85.7942581176759 22.710355758667106 0, 85.78676605224615 22.70713996887207 0, 85.77534484863287 22.7095108032226 0, 85.77330780029308 22.699268341064567 0, 85.76325988769531 22.70112419128418 0, 85.75569152832037 22.700765609741268 0, 85.74985504150385 22.70135498046875 0, 85.74530029296875 22.699316024780387 0, 85.74176788330084 22.693460464477596 0, 85.73499298095703 22.690767288208065 0, 85.73213195800781 22.69115257263178 0, 85.72888183593744 22.687313079833984 0, 85.72464752197277 22.685907363891545 0, 85.71837615966808 22.687801361084098 0, 85.71509552001964 22.69216346740734 0, 85.70967864990234 22.693197250366325 0, 85.70206451416021 22.696340560913086 0, 85.69902038574224 22.70161437988287 0, 85.69819641113281 22.707727432251033 0, 85.69541168212896 22.71293640136713 0, 85.69064331054693 22.716764450073242 0, 85.6901092529298 22.717395782470817 0, 85.68299102783209 22.725805282592887 0, 85.68126678466803 22.729557037353572 0, 85.68524169921875 22.741018295288143 0, 85.6906127929688 22.74579238891613 0, 85.69448852539074 22.74583244323742 0, 85.7018051147461 22.743337631225643 0, 85.70906829833984 22.742980957031307 0, 85.71406555175781 22.745925903320256 0, 85.71649932861328 22.7561550140382 0, 85.70885467529291 22.758470535278377 0, 85.70307922363293 22.762741088867188 0, 85.69937896728516 22.76905441284191 0, 85.69734954833996 22.774536132812443 0, 85.69467163085943 22.788673400878906 0, 85.69705963134766 22.802406311035156 0, 85.6997909545899 22.808017730712834 0, 85.6919784545899 22.81807899475092 0, 85.68054962158209 22.818229675292912 0, 85.67510986328125 22.825714111328125 0, 85.67363739013678 22.826526641845646 0, 85.669189453125 22.828975677490348 0, 85.66368865966797 22.830562591552734 0, 85.66085052490234 22.833892822265625 0, 85.65868377685541 22.83885955810547 0, 85.656021118164 22.841722488403263 0, 85.65156555175787 22.842164993286133 0, 85.64851379394537 22.845043182373047 0, 85.64663696289074 22.849996566772575 0, 85.64258575439459 22.850515365600643 0, 85.63601684570312 22.848087310791016 0, 85.63292694091808 22.84829330444336 0, 85.62679290771496 22.848705291748047 0, 85.6197128295899 22.848230361938477 0, 85.61803436279308 22.844051361084098 0, 85.61252593994135 22.833490371704215 0, 85.60732269287121 22.825834274291992 0, 85.59345245361322 22.827646255493164 0, 85.58475494384771 22.829372406005803 0, 85.57367706298828 22.831773757934684 0, 85.56674957275385 22.832487106323185 0, 85.56200408935547 22.826118469238338 0, 85.55673980712896 22.821611404419002 0, 85.54847717285156 22.82357215881359 0, 85.53910827636719 22.820690155029354 0, 85.53507232666027 22.807567596435604 0, 85.52865600585938 22.80863189697277 0, 85.51466369628918 22.809139251709098 0, 85.51464843750011 22.809144973754883 0, 85.5146865844726 22.809156417846793 0, 85.51476287841803 22.820854187011832 0, 85.51272583007824 22.829475402831974 0, 85.51875305175781 22.830993652343693 0, 85.51924133300793 22.836959838867188 0, 85.52108764648443 22.843852996826286 0, 85.52624511718756 22.84530830383312 0, 85.53035736083984 22.853879928588867 0, 85.5284423828125 22.864303588867244 0, 85.5320816040039 22.866275787353572 0, 85.53189086914062 22.869050979614258 0, 85.53919982910162 22.866577148437557 0, 85.54165649414068 22.870342254638786 0, 85.5466995239259 22.87509727478033 0, 85.55782318115234 22.881202697753906 0, 85.5586776733399 22.874773025512695 0, 85.55842590332031 22.86632156372076 0, 85.55978393554693 22.861925125122184 0, 85.57820892333984 22.866586685180664 0, 85.5858993530274 22.881418228149414 0, 85.58927154541016 22.885988235473576 0, 85.5981903076173 22.892198562622127 0, 85.6013793945313 22.89602661132824 0, 85.58891296386719 22.899198532104606 0, 85.58129119873047 22.898777008056754 0, 85.58000183105474 22.900335311889762 0, 85.5787734985351 22.906242370605526 0, 85.58123779296886 22.910467147827262 0, 85.59107208251959 22.922466278076115 0, 85.60490417480463 22.93626785278326 0, 85.61406707763672 22.933094024658317 0, 85.61473846435553 22.929506301879883 0, 85.613021850586 22.92359542846674 0, 85.61688232421886 22.91827201843273 0, 85.61983489990234 22.916894912719727 0, 85.6317596435548 22.91956710815441 0, 85.64459228515625 22.92021751403803 0, 85.6497039794923 22.921955108642578 0, 85.65327453613287 22.92774581909191 0, 85.65100860595714 22.93759155273449 0, 85.65568542480469 22.93834495544428 0, 85.67178344726568 22.9355792999267 0, 85.68063354492188 22.93529319763178 0, 85.69052886962902 22.93726348876953 0, 85.69509124755871 22.941326141357536 0, 85.7023391723634 22.944456100463867 0, 85.71851348876959 22.94278144836437 0, 85.72895812988287 22.942617416381893 0, 85.73915863037121 22.94001770019537 0, 85.74530029296875 22.93666267395031 0, 85.74983978271496 22.933132171630803 0, 85.76079559326172 22.93390274047846 0, 85.76477813720703 22.93066215515148 0, 85.76704406738281 22.926490783691463 0, 85.77262878417974 22.922382354736385 0, 85.78005981445312 22.922676086425838 0, 85.78706359863281 22.920070648193416 0, 85.79957580566412 22.910804748535213 0, 85.8092269897461 22.907745361328125 0, 85.81617736816418 22.907625198364315 0, 85.82108306884771 22.905540466308707 0, 85.82655334472656 22.904554367065543 0, 85.83460235595703 22.905429840088004 0, 85.83470916748058 22.902700424194336 0, 85.83280181884777 22.89726066589361 0, 85.83469390869152 22.89297485351574 0, 85.83738708496105 22.89030838012701 0, 85.84910583496094 22.885103225708065 0, 85.85678100585943 22.884641647338924 0, 85.86116027832037 22.887762069702262 0, 85.85792541503912 22.89697456359869 0, 85.85523986816412 22.901031494140625 0, 85.8579559326173 22.905132293701172 0, 85.86769104003918 22.91277885437006 0, 85.86843109130865 22.916086196899528 0, 85.86727905273443 22.918346405029354 0, 85.87067413330084 22.927377700805607 0, 85.87364959716791 22.930454254150504 0, 85.87260437011724 22.933002471923828 0, 85.86769104003918 22.935266494751033 0, 85.86671447753912 22.93961906433117 0, 85.86267089843756 22.943166732788086 0, 85.86182403564447 22.946716308593807 0, 85.85137176513672 22.945110321045036 0, 85.84947967529297 22.948669433593864 0, 85.84939575195324 22.962265014648438 0, 85.84619140625 22.97990226745617 0, 85.84603118896484 22.987304687500057 0, 85.8403930664063 22.988037109375 0, 85.83129119873058 22.99154663085949 0, 85.82474517822271 22.99691390991211 0, 85.82153320312511 23.0025310516358 0, 85.82210540771496 23.00329971313488 0, 85.8215713500976 23.006462097168082 0, 85.81871795654291 23.01219177246088 0, 85.81652832031256 23.02619171142578 0, 85.81198120117199 23.034357070922965 0, 85.8095169067384 23.043676376342773 0, 85.80558013916016 23.053628921508732 0, 85.79813385009766 23.056045532226676 0, 85.79690551757818 23.059703826904354 0, 85.79920959472668 23.06394004821783 0, 85.80265045166027 23.066793441772518 0, 85.8075561523438 23.06818771362299 0, 85.81234741210943 23.06860542297369 0, 85.8203811645509 23.08633804321289 0, 85.82394409179693 23.091663360595703 0, 85.82811737060547 23.092435836792106 0, 85.83336639404308 23.09888839721674 0, 85.83427429199224 23.102724075317383 0, 85.83769226074224 23.10462951660162 0, 85.83967590332043 23.106954574584904 0, 85.83977508544928 23.11070060729986 0, 85.84181213378906 23.1156330108642 0, 85.84574127197277 23.118932723999137 0, 85.85056304931635 23.120056152343807 0, 85.85765838623047 23.13035011291504 0, 85.86447143554699 23.12693214416504 0, 85.86818695068365 23.126462936401367 0, 85.87025451660156 23.129135131835938 0, 85.87029266357428 23.134717941284237 0, 85.86906433105463 23.14191436767578 0, 85.87061309814453 23.145725250244197 0, 85.87393951416021 23.148395538330135 0, 85.8785858154298 23.150598526000977 0, 85.8819198608399 23.150264739990234 0, 85.88529968261719 23.152685165405387 0, 85.88620758056652 23.15536880493164 0, 85.89299774169928 23.154642105102596 0))",both
